rep1_GAGATTCCAGGCAGAAACTGCATATATAGCCT	IN1
rep1_AGCGATAGCGTACTAGACTGCATACAGGACGT	EX3
rep1_AGCGATAGACTGAGCGATCTGAGTTATAGCCT	AC
rep1_GAGATTCCATGCGCAGATCTGAGTATAGAGGC	EX3
rep1_CTGAAGCTTCGACGTCCTCTCTATATAGAGGC	EX3
rep1_GAGATTCCGCTCATGATATCCTCTATAGAGGC	IN1
rep1_AGCGATAGACTCGCTATTATGCGATATAGCCT	AC
rep1_GAGATTCCAGGCAGAACTCTCTATCAGGACGT	EX3
rep1_CGGCTATGAAGAGGCAAAGGAGTAATAGAGGC	EX3
rep1_CTGAAGCTGGAGCTACATCTGAGTCAGGACGT	IN1
rep1_CTGAAGCTATCTCAGGGTAAGGAGATAGAGGC	EX2
rep1_CGCTCATTTCCTGAGCCCTAGAGTCAGGACGT	EX3
rep1_AGCGATAGCTCTGGTAGCGTAAGACAGGACGT	EX3
rep1_AGCGATAGACTCGCTATTATGCGAATAGAGGC	MG
rep1_GAGATTCCATCTCAGGAAGGAGTATATAGCCT	EX2
rep1_CTGAAGCTCTCTCTACAAGGCTATATAGAGGC	EX2
rep1_CTGAAGCTCGAGGCTGAAGGAGTAATAGAGGC	EX1
rep1_CTGAAGCTAGGCAGAACTAAGCCTATAGAGGC	EX1
rep1_GAGATTCCCTCTCTACCTAAGCCTCAGGACGT	OC
rep1_CGGCTATGTAGGCATGAAGGCTATTATAGCCT	OC
rep1_CTGAAGCTTACGCTGCCGTCTAATATAGAGGC	OC
rep1_GAGATTCCCGAGGCTGTCTCTCCGTATAGCCT	AC
rep1_ATTACTCGCGAGGCTGTTATGCGATATAGCCT	EX3
rep1_GAGATTCCGGAGCTACCGTCTAATTATAGCCT	IN2
rep1_GAGATTCCTAGGCATGGCGTAAGACAGGACGT	EX3
rep1_CGGCTATGATCTCAGGGTAAGGAGATAGAGGC	EX1
rep1_GAGATTCCGCGTAGTATCTCTCCGCAGGACGT	EX2
rep1_CTGAAGCTGTAGAGGACTAAGCCTATAGAGGC	IN1
rep1_GAGATTCCTAAGGCGACTCTCTATTATAGCCT	AC
rep1_CTGAAGCTAAGAGGCATCGACTAGGGCTCTGA	IN1
rep1_TCCGGAGAGCTCATGAATCTGAGTCAGGACGT	AC
rep1_AGCGATAGGGACTCCTCTAAGCCTTATAGCCT	AC
rep1_TCCGGAGATCGACGTCTCTCTCCGCAGGACGT	EX1
rep1_GAGATTCCTAGGCATGTTCTAGCTTATAGCCT	EX1
rep1_TCCGGAGAGTAGAGGACTCTCTATATAGAGGC	EX1
rep1_AGCGATAGGGAGCTACTTCTAGCTTATAGCCT	OC
rep1_ATTACTCGCGAGGCTGTCTCTCCGATAGAGGC	EX1
rep1_TCCGGAGAACTCGCTATTATGCGAATAGAGGC	EX1
rep1_GAGATTCCAAGAGGCAGCGTAAGAATAGAGGC	EX3
rep1_ATTACTCGCGTACTAGATCTGAGTTATAGCCT	EX2
rep1_CGGCTATGGCTCATGAAAGGCTATTATAGCCT	EX3
rep1_GAGATTCCGCGTAGTATTATGCGACAGGACGT	EX3
rep1_GAGATTCCGTAGAGGAGCGTAAGATATAGCCT	EX2
rep1_AGCGATAGGTAGAGGAAAGGAGTAATAGAGGC	AC
rep1_GAGATTCCCGATCAGTCTCTCTATTATAGCCT	EX1
rep1_TCCGGAGATACGCTGCACTGCATATATAGCCT	EX3
rep1_CGCTCATTGCGTAGTACTCTCTATGGCTCTGA	EX2
rep1_GAGATTCCCGATCAGTCGTCTAATTATAGCCT	EX2
rep1_AGCGATAGTAGCGCTCGTAAGGAGCAGGACGT	EX2
rep1_CTGAAGCTAAGAGGCATCTCTCCGATAGAGGC	MG
rep1_AGCGATAGTCCTGAGCATCTGAGTATAGAGGC	IN2
rep1_GAGATTCCCGAGGCTGAAGGCTATCAGGACGT	EX3
rep1_AGCGATAGAGGCAGAAACTGCATATATAGCCT	MG
rep1_AGCGATAGTAAGGCGAACTGCATACAGGACGT	EX2
rep1_AGCGATAGCGTACTAGAAGGAGTATATAGCCT	EX1
rep1_AGCGATAGGTAGAGGACCTAGAGTATAGAGGC	EX2
rep1_AGCGATAGGCTCATGACGTCTAATCAGGACGT	EX2
rep1_TCCGGAGAAAGAGGCAGAGCCTTACCTATCCT	OC
rep1_TCCGGAGATAGGCATGTTATGCGATATAGCCT	EX1
rep1_ATTACTCGACTGAGCGAAGGAGTATATAGCCT	EX3
rep1_CTGAAGCTTACGCTGCATCTGAGTATAGAGGC	EX3
rep1_TCCGGAGACCTAAGACTCGACTAGCAGGACGT	EX3
rep1_CTGAAGCTCCTAAGACGAGCCTTAATAGAGGC	EX1
rep1_GAGATTCCTACGCTGCCTCTCTATATAGAGGC	EX3
rep1_CTGAAGCTGTAGAGGAAAGGAGTAATAGAGGC	EX1
rep1_GAGATTCCTCCTGAGCCTCTCTATATAGAGGC	EX1
rep1_GAGATTCCCTCTCTACCCTAGAGTTATAGCCT	IN1
rep1_AGCGATAGTAGCGCTCATCTGAGTTATAGCCT	EX3
rep1_GAGATTCCATCTCAGGCTAAGCCTGGCTCTGA	EX3
rep1_CTGAAGCTATCTCAGGGAGCCTTAATAGAGGC	EX1
rep1_GAGATTCCCTCTGGTAGTAAGGAGTATAGCCT	IN1
rep1_GAGATTCCCTCTGGTATTATGCGACAGGACGT	EX2
rep1_CGGCTATGCCTAAGACCTAAGCCTCAGGACGT	MG
rep1_GAGATTCCTAGGCATGTTATGCGATATAGCCT	AC
rep1_GAGATTCCGGACTCCTATCTGAGTTATAGCCT	EX2
rep1_TCCGGAGAGTAGAGGACGTCTAATTATAGCCT	EX1
rep1_CTGAAGCTTCGACGTCTTCTAGCTATAGAGGC	AC
rep1_AGCGATAGCCTAAGACCTAAGCCTCAGGACGT	AC
rep1_GAGATTCCGGACTCCTCGTCTAATCAGGACGT	OC
rep1_GAGATTCCCTCTCTACCCTAGAGTCAGGACGT	IN1
rep1_CGGCTATGGCTCATGACGTCTAATTATAGCCT	EX1
rep1_GAGATTCCCGTACTAGCTCTCTATGGCTCTGA	EX1
rep1_GAGATTCCCTCTCTACAAGGCTATTATAGCCT	MG
rep1_CGGCTATGTAGCGCTCAAGGCTATATAGAGGC	EX2
rep1_CTGAAGCTCTCTCTACTTATGCGAATAGAGGC	IN1
rep1_AGCGATAGTAAGGCGATCTCTCCGCAGGACGT	MG
rep1_CTGAAGCTTCCTGAGCTATCCTCTATAGAGGC	IN1
rep1_TCCGGAGATCGACGTCGCGTAAGAATAGAGGC	EX3
rep1_AGCGATAGGGACTCCTCGTCTAATATAGAGGC	IN2
rep1_AGCGATAGCGTACTAGTTATGCGATATAGCCT	IN2
rep1_AGCGATAGATCTCAGGGCGTAAGATATAGCCT	EX3
rep1_ATTCAGAAGGAGCTACGAGCCTTACAGGACGT	EX3
rep1_AGCGATAGCTCTCTACTTATGCGATATAGCCT	EX3
rep1_ATTACTCGCCTAAGACAAGGCTATTATAGCCT	IN2
rep1_CGCTCATTTAGGCATGTCGACTAGTATAGCCT	EX3
rep1_GAGATTCCTCCTGAGCCTAAGCCTCAGGACGT	EX1
rep1_GAGATTCCCTCTGGTAGCGTAAGATATAGCCT	EX2
rep1_AGCGATAGTGCAGCTAATCTGAGTTATAGCCT	EX3
rep1_AGCGATAGCCTAAGACAAGGAGTACAGGACGT	EX3
rep1_CGGCTATGCGTACTAGGTAAGGAGTATAGCCT	EX3
rep1_CGCTCATTGGAGCTACCGTCTAATATAGAGGC	EX3
rep1_CGGCTATGTACGCTGCTTCTAGCTATAGAGGC	EX3
rep1_GAGATTCCATCTCAGGCGTCTAATTATAGCCT	EX2
rep1_CGGCTATGCGTACTAGTCTCTCCGATAGAGGC	EX2
rep1_ATTACTCGCTCTGGTACTAAGCCTATAGAGGC	EX3
rep1_CTGAAGCTGGACTCCTCCTAGAGTGGCTCTGA	EX3
rep1_TCCGGAGATAGGCATGTTCTAGCTCAGGACGT	EX2
rep1_TCCGGAGAGTAGAGGAGAGCCTTAATAGAGGC	EX3
rep1_CGCTCATTGGAGCTACAAGGCTATCAGGACGT	EX2
rep1_AGCGATAGTAAGGCGATCGACTAGCAGGACGT	AC
rep1_CGCTCATTTGCAGCTACTAAGCCTATAGAGGC	EX3
rep1_CTGAAGCTTGCAGCTAATCTGAGTATAGAGGC	EX2
rep1_TCCGGAGAAGGCAGAACCTAGAGTTATAGCCT	EX3
rep1_ATTACTCGTAGCGCTCTTCTAGCTCAGGACGT	EX1
rep1_CTGAAGCTCTCTGGTACGTCTAATATAGAGGC	EX3
rep1_AGCGATAGACTGAGCGCCTAGAGTTATAGCCT	OC
rep1_GAGATTCCTCGACGTCTCTCTCCGATAGAGGC	IN2
rep1_AGCGATAGCGATCAGTCGTCTAATCAGGACGT	EX1
rep1_TCCGGAGACTCTCTACTCTCTCCGCAGGACGT	EX2
rep1_TCCGGAGACGTACTAGTCGACTAGGGCTCTGA	IN1
rep1_TCCGGAGAAAGAGGCAGTAAGGAGGGCTCTGA	IN2
rep1_TCCGGAGATCGACGTCTTATGCGAATAGAGGC	AC
rep1_AGCGATAGATGCGCAGGTAAGGAGTATAGCCT	IN1
rep1_TCCGGAGACCTAAGACTTCTAGCTATAGAGGC	IN2
rep1_CTGAAGCTATCTCAGGATCTGAGTCAGGACGT	EX1
rep1_CGCTCATTACTGAGCGTCGACTAGTATAGCCT	EX3
rep1_TCCGGAGAAAGAGGCAATCTGAGTATAGAGGC	IN1
rep1_GAGATTCCGGACTCCTTCTCTCCGCAGGACGT	EX3
rep1_GAGATTCCACTGAGCGCTCTCTATATAGAGGC	EX3
rep1_AGCGATAGTCGACGTCAAGGCTATTATAGCCT	IN1
rep1_GAGATTCCTAAGGCGACTAAGCCTATAGAGGC	EX3
rep1_CTGAAGCTCGTACTAGGCGTAAGAATAGAGGC	IN2
rep1_AGCGATAGTCCTGAGCGCGTAAGATATAGCCT	IN2
rep1_GAGATTCCGGAGCTACGTAAGGAGGGCTCTGA	EX1
rep1_CGGCTATGTAAGGCGATCTCTCCGATAGAGGC	EX2
rep1_AGCGATAGAAGAGGCACCTAGAGTTATAGCCT	EX2
rep1_AGCGATAGCGATCAGTACTGCATAATAGAGGC	EX2
rep1_ATTACTCGACTCGCTAGAGCCTTACAGGACGT	EX3
rep1_GAGATTCCGTAGAGGAGTAAGGAGTATAGCCT	OC
rep1_CGGCTATGTCCTGAGCGAGCCTTATATAGCCT	EX3
rep1_CTGAAGCTAAGAGGCATTATGCGAATAGAGGC	EX1
rep1_GAGATTCCCTCTCTACTCTCTCCGCAGGACGT	OC
rep1_CGGCTATGCGATCAGTACTGCATAATAGAGGC	EX2
rep1_CGGCTATGGCGTAGTACCTAGAGTATAGAGGC	EX2
rep1_TCCGGAGAGCTCATGATCGACTAGATAGAGGC	EX1
rep1_AGCGATAGTGCAGCTATCTCTCCGTATAGCCT	IN2
rep1_CTGAAGCTCGTACTAGGCGTAAGACAGGACGT	EX3
rep1_TCCGGAGAGCGTAGTATCGACTAGATAGAGGC	IN1
rep1_GAGATTCCCTCTCTACACTGCATATATAGCCT	EX3
rep1_CGCTCATTCGAGGCTGATCTGAGTATAGAGGC	EX1
rep1_CGGCTATGTCCTGAGCCTCTCTATTATAGCCT	EX3
rep1_CTGAAGCTTCGACGTCTATCCTCTATAGAGGC	EX3
rep1_GAGATTCCCGATCAGTCTAAGCCTATAGAGGC	EX1
rep1_ATTACTCGCTCTGGTAATCTGAGTATAGAGGC	EX1
rep1_ATTACTCGTAAGGCGATTATGCGATATAGCCT	EX3
rep1_CTGAAGCTCGTACTAGTATCCTCTCAGGACGT	EX3
rep1_CTGAAGCTTAGGCATGATCTGAGTCCTATCCT	EX3
rep1_CGCTCATTACTCGCTATTATGCGACAGGACGT	EX2
rep1_ATTACTCGACTCGCTATTATGCGAATAGAGGC	EX1
rep1_GAGATTCCGCGTAGTAGTAAGGAGATAGAGGC	EX2
rep1_AGCGATAGCTCTCTACCGTCTAATTATAGCCT	EX1
rep1_CGCTCATTTAAGGCGATCGACTAGTATAGCCT	EX1
rep1_GAGATTCCTAGGCATGTTATGCGACAGGACGT	EX3
rep1_ATTACTCGTAGGCATGAAGGCTATTATAGCCT	EX1
rep1_AGCGATAGATCTCAGGTTATGCGAATAGAGGC	EX3
rep1_TCCGGAGATAGGCATGGTAAGGAGATAGAGGC	EX3
rep1_AGCGATAGCGTACTAGTCTCTCCGCAGGACGT	MG
rep1_TCCGCGAATACGCTGCCGTCTAATCAGGACGT	EX3
rep1_GAGATTCCATCTCAGGTCGACTAGTATAGCCT	OC
rep1_CGCTCATTCGAGGCTGGAGCCTTATATAGCCT	EX2
rep1_GAGATTCCATCTCAGGCTAAGCCTTATAGCCT	EX3
rep1_CGCTCATTTAAGGCGAACTGCATAGGCTCTGA	EX1
rep1_CGGCTATGTCGACGTCTTCTAGCTATAGAGGC	EX1
rep1_CTGAAGCTGTAGAGGAAAGGCTATCAGGACGT	EX3
rep1_GAGATTCCGCTCATGATCTCTCCGTATAGCCT	IN2
rep1_CGGCTATGAGGCAGAAGAGCCTTAATAGAGGC	EX3
rep1_AGCGATAGTAGGCATGGTAAGGAGTATAGCCT	EX3
rep1_AGCGATAGCGATCAGTCGTCTAATTATAGCCT	EX2
rep1_AGCGATAGCGATCAGTGCGTAAGAATAGAGGC	IN1
rep1_CTGAAGCTAGGCAGAAACTGCATATATAGCCT	EX3
rep1_CGGCTATGCGTACTAGACTGCATAATAGAGGC	EX1
rep1_CTGAAGCTTAGCGCTCCCTAGAGTTATAGCCT	EX3
rep1_AGCGATAGCGTACTAGCTCTCTATATAGAGGC	OC
rep1_ATTACTCGTAGCGCTCCCTAGAGTGGCTCTGA	EX3
rep1_CTGAAGCTGCTCATGATTCTAGCTATAGAGGC	IN2
rep1_AGCGATAGACTGAGCGCGTCTAATCAGGACGT	EX3
rep1_CGCTCATTCGAGGCTGTCGACTAGCAGGACGT	EX2
rep1_ATTACTCGGGAGCTACAAGGAGTAATAGAGGC	EX1
rep1_CGGCTATGAAGAGGCAATCTGAGTTATAGCCT	EX1
rep1_CGCTCATTATCTCAGGAAGGCTATATAGAGGC	EX3
rep1_CGGCTATGCTCTCTACATCTGAGTATAGAGGC	EX1
rep1_GAGATTCCCTCTGGTATCGACTAGCAGGACGT	IN2
rep1_AGCGATAGCTCTCTACTTCTAGCTTATAGCCT	IN2
rep1_TCCGGAGACCTAAGACGAGCCTTACAGGACGT	EX1
rep1_GAGATTCCCCTAAGACACTGCATACAGGACGT	OC
rep1_CGGCTATGGCTCATGATTATGCGATATAGCCT	IN1
rep1_AGCGATAGTGCAGCTAAAGGAGTACAGGACGT	AC
rep1_CGCTCATTAAGAGGCATCGACTAGCAGGACGT	EX2
rep1_TCCGGAGACCTAAGACACTGCATACAGGACGT	EX3
rep1_AGCGATAGCGTACTAGTTCTAGCTATAGAGGC	EX1
rep1_TCCGGAGACGATCAGTCTCTCTATATAGAGGC	EX2
rep1_CGGCTATGTAGCGCTCTATCCTCTCAGGACGT	MG
rep1_CGGCTATGATCTCAGGTCTCTCCGCAGGACGT	IN2
rep1_CTGAAGCTGTAGAGGAAAGGCTATATAGAGGC	IN2
rep1_CGGCTATGGGAGCTACATCTGAGTTATAGCCT	IN1
rep1_CGGCTATGTACGCTGCAAGGAGTATATAGCCT	IN2
rep1_CTGAAGCTATGCGCAGTCGACTAGCAGGACGT	EX2
rep1_CGGCTATGTCCTGAGCCCTAGAGTTATAGCCT	EX1
rep1_TCCGGAGACGAGGCTGCCTAGAGTCAGGACGT	EX2
rep1_AGCGATAGTAGCGCTCCTCTCTATCAGGACGT	AC
rep1_ATTCAGAACTCTCTACTCTCTCCGCAGGACGT	EX1
rep1_CGGCTATGGGACTCCTATCTGAGTCAGGACGT	IN1
rep1_TCCGGAGACGAGGCTGTTATGCGATATAGCCT	IN2
rep1_ATTCAGAATAGGCATGATCTGAGTCCTATCCT	EX3
rep1_GAGATTCCCTCTGGTACTAAGCCTTATAGCCT	OC
rep1_GAGATTCCCGATCAGTGTAAGGAGTATAGCCT	MG
rep1_CGCTCATTCTCTGGTACTCTCTATATAGAGGC	EX1
rep1_CTGAAGCTTAGGCATGTTCTAGCTCAGGACGT	EX2
rep1_CTGAAGCTCTCTCTACCGTCTAATATAGAGGC	IN1
rep1_AGCGATAGCTCTCTACTCTCTCCGCAGGACGT	IN1
rep1_AGCGATAGTGCAGCTACTAAGCCTTATAGCCT	IN2
rep1_CGCTCATTTACGCTGCTCTCTCCGCCTATCCT	EX2
rep1_TCCGGAGACTCTCTACAAGGCTATCAGGACGT	AC
rep1_TCCGGAGAGGAGCTACAAGGCTATTATAGCCT	AC
rep1_GAGATTCCATGCGCAGATCTGAGTCAGGACGT	OC
rep1_ATTCAGAACTCTCTACACTGCATACCTATCCT	EX2
rep1_CTGAAGCTGCTCATGATTCTAGCTCAGGACGT	AC
rep1_CGGCTATGGGACTCCTATCTGAGTTATAGCCT	EX3
rep1_TCCGGAGAGGAGCTACTATCCTCTCAGGACGT	EX3
rep1_CGGCTATGTCGACGTCGCGTAAGATATAGCCT	OC
rep1_CTGAAGCTCCTAAGACGCGTAAGAGGCTCTGA	EX2
rep1_TCCGCGAATCGACGTCCCTAGAGTCAGGACGT	EX3
rep1_CGGCTATGGGACTCCTTCGACTAGTATAGCCT	AC
rep1_GAGATTCCGGAGCTACTTATGCGAATAGAGGC	EX3
rep1_GAGATTCCCTCTGGTAACTGCATAATAGAGGC	AC
rep1_CGGCTATGATCTCAGGAAGGAGTAATAGAGGC	IN1
rep1_AGCGATAGGCTCATGACTAAGCCTATAGAGGC	EX3
rep1_GAGATTCCCCTAAGACCTCTCTATCAGGACGT	EX3
rep1_AGCGATAGTGCAGCTACGTCTAATTATAGCCT	EX1
rep1_GAGATTCCGGAGCTACGAGCCTTACAGGACGT	EX3
rep1_CGGCTATGCGATCAGTTCGACTAGATAGAGGC	EX2
rep1_TCCGCGAAGCGTAGTAACTGCATAGGCTCTGA	EX3
rep1_TCCGGAGAGGAGCTACCTCTCTATGGCTCTGA	AC
rep1_CGCTCATTTAGGCATGACTGCATATATAGCCT	EX3
rep1_GAGATTCCGCTCATGAACTGCATACAGGACGT	EX2
rep1_AGCGATAGGCGTAGTAGTAAGGAGTATAGCCT	IN2
rep1_AGCGATAGCGTACTAGTATCCTCTTATAGCCT	EX2
rep1_ATTACTCGTAAGGCGACTCTCTATTATAGCCT	EX1
rep1_AGCGATAGCGATCAGTAAGGCTATCCTATCCT	EX3
rep1_CGCTCATTATCTCAGGATCTGAGTGGCTCTGA	IN2
rep1_GAGATTCCGGACTCCTCTCTCTATCAGGACGT	EX1
rep1_GAGATTCCATCTCAGGCTAAGCCTATAGAGGC	EX3
rep1_CTGAAGCTTAGCGCTCCTCTCTATTATAGCCT	EX3
rep1_TCCGGAGATAAGGCGAAAGGCTATATAGAGGC	EX2
rep1_TCCGGAGACGTACTAGCGTCTAATCAGGACGT	EX1
rep1_CGGCTATGTAAGGCGAATCTGAGTCAGGACGT	IN1
rep1_CGGCTATGATGCGCAGGAGCCTTATATAGCCT	EX3
rep1_AGCGATAGCGAGGCTGCGTCTAATCAGGACGT	EX3
rep1_GAGATTCCTCCTGAGCCTAAGCCTATAGAGGC	IN1
rep1_CGGCTATGCCTAAGACCTAAGCCTTATAGCCT	EX2
rep1_TCCGGAGAATCTCAGGTTCTAGCTATAGAGGC	EX2
rep1_GAGATTCCTACGCTGCCTAAGCCTCAGGACGT	EX3
rep1_CGCTCATTGGACTCCTTCTCTCCGGGCTCTGA	IN2
rep1_CGCTCATTGCTCATGAACTGCATACAGGACGT	EX3
rep1_TCCGGAGAAAGAGGCACTAAGCCTCAGGACGT	EX3
rep1_GAGATTCCATGCGCAGTTCTAGCTCAGGACGT	OC
rep1_ATTACTCGCGATCAGTATCTGAGTCAGGACGT	EX3
rep1_GAGATTCCCGTACTAGTTATGCGAGGCTCTGA	EX3
rep1_ATTACTCGCGTACTAGTTATGCGATATAGCCT	EX3
rep1_TCCGGAGATCGACGTCGAGCCTTACAGGACGT	IN2
rep1_CGGCTATGACTGAGCGTTATGCGATATAGCCT	EX2
rep1_CGCTCATTAGGCAGAAGCGTAAGAGGCTCTGA	IN2
rep1_TCCGGAGAAAGAGGCAGAGCCTTAATAGAGGC	OC
rep1_GAGATTCCATGCGCAGTTCTAGCTGGCTCTGA	EX3
rep1_CGCTCATTAAGAGGCACCTAGAGTCAGGACGT	EX3
rep1_CGCTCATTCCTAAGACCCTAGAGTCAGGACGT	EX3
rep1_CGCTCATTCGTACTAGCGTCTAATCAGGACGT	IN2
rep1_ATTACTCGAGGCAGAAATCTGAGTTATAGCCT	IN2
rep1_AGCGATAGTGCAGCTACCTAGAGTCAGGACGT	IN2
rep1_GAGATTCCCGATCAGTTTCTAGCTATAGAGGC	IN2
rep1_GAGATTCCAAGAGGCATATCCTCTTATAGCCT	EX2
rep1_ATTACTCGTAGGCATGTTATGCGATATAGCCT	EX2
rep1_TCCGCGAAAAGAGGCAATCTGAGTCAGGACGT	IN1
rep1_TCCGGAGAGCTCATGAACTGCATACAGGACGT	MG
rep1_GAGATTCCCGTACTAGAAGGCTATATAGAGGC	MG
rep1_AGCGATAGTCCTGAGCGAGCCTTATATAGCCT	EX2
rep1_AGCGATAGACTGAGCGAAGGCTATATAGAGGC	EX2
rep1_TCCGCGAATCGACGTCACTGCATAGGCTCTGA	EX3
rep1_GAGATTCCACTCGCTACGTCTAATTATAGCCT	OC
rep1_ATTACTCGTAGGCATGCCTAGAGTGGCTCTGA	EX3
rep1_CGCTCATTCTCTCTACCTCTCTATCCTATCCT	EX2
rep1_TCCGGAGAATGCGCAGTTCTAGCTTATAGCCT	EX3
rep1_CGGCTATGGGAGCTACCGTCTAATTATAGCCT	EX2
rep1_GAGATTCCTCGACGTCAAGGCTATGGCTCTGA	EX3
rep1_ATTCAGAACTCTCTACCCTAGAGTCCTATCCT	IN2
rep1_GAGATTCCCGTACTAGCTCTCTATTATAGCCT	AC
rep1_CGGCTATGATCTCAGGACTGCATACAGGACGT	IN2
rep1_TCCGGAGACGAGGCTGTATCCTCTTATAGCCT	EX2
rep1_ATTCAGAAGGAGCTACCTAAGCCTTATAGCCT	EX2
rep1_ATTACTCGGCGTAGTATATCCTCTATAGAGGC	EX3
rep1_AGCGATAGGCTCATGATTATGCGATATAGCCT	IN2
rep1_TCCGGAGACGAGGCTGTCGACTAGTATAGCCT	IN1
rep1_CTGAAGCTTCGACGTCATCTGAGTATAGAGGC	IN2
rep1_ATTACTCGTAAGGCGAAAGGAGTACAGGACGT	EX3
rep1_TCCGGAGATCCTGAGCGTAAGGAGGGCTCTGA	EX1
rep1_GAGATTCCCTCTCTACAAGGAGTACAGGACGT	AC
rep1_CGGCTATGTCGACGTCCGTCTAATTATAGCCT	IN2
rep1_CGCTCATTCGAGGCTGAAGGCTATTATAGCCT	OC
rep1_CGCTCATTCTCTCTACTATCCTCTCAGGACGT	EX3
rep1_CGGCTATGATCTCAGGCTCTCTATATAGAGGC	EX1
rep1_GAGATTCCTGCAGCTATATCCTCTTATAGCCT	EX1
rep1_TCCGGAGAGCTCATGATTATGCGATATAGCCT	IN1
rep1_CGGCTATGTGCAGCTAGAGCCTTAATAGAGGC	IN1
rep1_GAGATTCCCCTAAGACTCGACTAGTATAGCCT	EX2
rep1_CTGAAGCTCTCTCTACTCTCTCCGCAGGACGT	EX3
rep1_CGGCTATGATGCGCAGGAGCCTTAATAGAGGC	OC
rep1_AGCGATAGTACGCTGCGCGTAAGAATAGAGGC	EX3
rep1_TCCGGAGAACTGAGCGTTCTAGCTCAGGACGT	IN1
rep1_CTGAAGCTCGAGGCTGGTAAGGAGTATAGCCT	IN1
rep1_CTGAAGCTACTCGCTACTAAGCCTCAGGACGT	IN1
rep1_GAGATTCCGCGTAGTACGTCTAATTATAGCCT	IN2
rep1_TAATGCGCTAGGCATGAAGGAGTACAGGACGT	MG
rep1_GAGATTCCTAGCGCTCATCTGAGTTATAGCCT	AC
rep1_CGGCTATGTAGCGCTCAAGGCTATTATAGCCT	IN2
rep1_CTGAAGCTCGAGGCTGTCTCTCCGCCTATCCT	IN1
rep1_ATTACTCGAGGCAGAAGTAAGGAGGGCTCTGA	EX3
rep1_ATTCAGAAATGCGCAGGAGCCTTACAGGACGT	EX3
rep1_TCCGGAGAATCTCAGGTCTCTCCGCAGGACGT	EX2
rep1_TCCGCGAATCGACGTCTTCTAGCTTATAGCCT	EX2
rep1_ATTACTCGGTAGAGGACTAAGCCTTATAGCCT	EX1
rep1_CGCTCATTTCGACGTCTATCCTCTATAGAGGC	IN2
rep1_GAGATTCCAAGAGGCAGCGTAAGACAGGACGT	EX2
rep1_GAGATTCCGCTCATGAGAGCCTTACAGGACGT	IN2
rep1_GAGATTCCGGACTCCTCTCTCTATGGCTCTGA	IN2
rep1_AGCGATAGCGTACTAGCGTCTAATATAGAGGC	AC
rep1_TCCGGAGAATGCGCAGTTATGCGATATAGCCT	EX1
rep1_CGGCTATGACTGAGCGACTGCATACAGGACGT	IN2
rep1_TCCGGAGACTCTGGTATTCTAGCTATAGAGGC	IN1
rep1_GAGATTCCGCTCATGAAAGGAGTACAGGACGT	EX3
rep1_ATTCAGAAAAGAGGCATTCTAGCTCCTATCCT	MG
rep1_CGGCTATGGGAGCTACAAGGAGTATATAGCCT	OC
rep1_AGCGATAGTACGCTGCTTCTAGCTCCTATCCT	EX3
rep1_CGCTCATTAAGAGGCATTCTAGCTATAGAGGC	EX1
rep1_GAGATTCCTACGCTGCTTCTAGCTTATAGCCT	IN2
rep1_ATTACTCGCCTAAGACCGTCTAATCAGGACGT	EX1
rep1_AGCGATAGGCGTAGTACCTAGAGTTATAGCCT	IN1
rep1_TCCGGAGACTCTCTACTTCTAGCTCAGGACGT	EX3
rep1_AGCGATAGGGAGCTACTATCCTCTATAGAGGC	IN2
rep1_CGCTCATTGTAGAGGAACTGCATACAGGACGT	EX2
rep1_AGCGATAGTCGACGTCCTAAGCCTCAGGACGT	EX3
rep1_ATTACTCGCGAGGCTGTTATGCGAGGCTCTGA	EX3
rep1_CGCTCATTGCTCATGACGTCTAATCCTATCCT	EX2
rep1_AGCGATAGGGAGCTACCTAAGCCTCAGGACGT	EX1
rep1_CGCTCATTTACGCTGCTCTCTCCGCAGGACGT	EX2
rep1_CGGCTATGCTCTGGTACCTAGAGTGGCTCTGA	EX3
rep1_CTGAAGCTGTAGAGGATTATGCGATATAGCCT	EX2
rep1_CTGAAGCTAGGCAGAAATCTGAGTTATAGCCT	EX2
rep1_GAGATTCCCGTACTAGATCTGAGTATAGAGGC	EX2
rep1_GAGATTCCTCGACGTCCCTAGAGTCCTATCCT	IN2
rep1_TCCGGAGACTCTCTACGCGTAAGATATAGCCT	EX2
rep1_TCCGGAGACCTAAGACTTCTAGCTCAGGACGT	EX2
rep1_TCCGGAGAGCGTAGTAATCTGAGTCAGGACGT	IN2
rep1_GAGATTCCATCTCAGGTATCCTCTATAGAGGC	IN1
rep1_TCCGGAGAATCTCAGGGTAAGGAGATAGAGGC	EX3
rep1_CGCTCATTTGCAGCTAAAGGCTATCAGGACGT	EX2
rep1_ATTCAGAATCCTGAGCCCTAGAGTCAGGACGT	EX1
rep1_CTGAAGCTGTAGAGGATTCTAGCTATAGAGGC	EX1
rep1_ATTACTCGTAGGCATGGAGCCTTAATAGAGGC	EX2
rep1_GAGATTCCGGAGCTACGTAAGGAGCAGGACGT	IN1
rep1_AGCGATAGATGCGCAGTTCTAGCTTATAGCCT	IN2
rep1_CTGAAGCTAAGAGGCAAAGGCTATGGCTCTGA	EX3
rep1_GAGATTCCTAGCGCTCGCGTAAGACAGGACGT	OC
rep1_ATTCAGAACCTAAGACACTGCATACCTATCCT	EX2
rep1_TCCGGAGAAAGAGGCAACTGCATAGGCTCTGA	EX3
rep1_TCCGGAGAGCGTAGTATATCCTCTCAGGACGT	EX3
rep1_GAGATTCCATGCGCAGACTGCATACCTATCCT	EX1
rep1_GAGATTCCGGAGCTACGTAAGGAGTATAGCCT	IN2
rep1_CGCTCATTGGAGCTACCTCTCTATATAGAGGC	AC
rep1_AGCGATAGCTCTGGTACTCTCTATTATAGCCT	IN2
rep1_AGCGATAGGGAGCTACCCTAGAGTTATAGCCT	AC
rep1_AGCGATAGTACGCTGCCGTCTAATATAGAGGC	EX2
rep1_TCCGGAGATGCAGCTAGAGCCTTAATAGAGGC	IN1
rep1_GAGATTCCAGGCAGAATCGACTAGATAGAGGC	EX2
rep1_ATTACTCGGCGTAGTAAAGGCTATGGCTCTGA	EX3
rep1_GAGATTCCTAAGGCGAGCGTAAGATATAGCCT	EX1
rep1_ATTCAGAAATCTCAGGTCGACTAGTATAGCCT	EX2
rep1_AGCGATAGGGAGCTACACTGCATACAGGACGT	IN1
rep1_CGCTCATTGCTCATGAGAGCCTTAATAGAGGC	EX3
rep1_CGCTCATTGCTCATGAAAGGCTATTATAGCCT	EX2
rep1_TCCGGAGAGTAGAGGACTAAGCCTTATAGCCT	EX3
rep1_TCCGGAGATGCAGCTACCTAGAGTATAGAGGC	EX3
rep1_CGCTCATTCGTACTAGGCGTAAGATATAGCCT	EX3
rep1_CTGAAGCTTAAGGCGACTCTCTATGGCTCTGA	IN2
rep1_AGCGATAGCGAGGCTGGAGCCTTAATAGAGGC	IN2
rep1_AGCGATAGATGCGCAGCCTAGAGTATAGAGGC	IN2
rep1_TCCGGAGATGCAGCTATCGACTAGCAGGACGT	IN1
rep1_TCCGCGAAGGACTCCTCTAAGCCTTATAGCCT	IN1
rep1_CGGCTATGGGAGCTACTTCTAGCTTATAGCCT	EX2
rep1_AGCGATAGAAGAGGCATTATGCGATATAGCCT	OC
rep1_TCCGGAGAACTGAGCGCCTAGAGTATAGAGGC	EX3
rep1_AGCGATAGCGATCAGTAAGGAGTAATAGAGGC	IN2
rep1_CGGCTATGGCGTAGTACTCTCTATGGCTCTGA	EX3
rep1_CGCTCATTTAAGGCGATCGACTAGGGCTCTGA	EX3
rep1_AGCGATAGCTCTGGTACGTCTAATATAGAGGC	IN2
rep1_CGCTCATTCTCTCTACCTAAGCCTCAGGACGT	EX2
rep1_GAGATTCCTCCTGAGCCGTCTAATCCTATCCT	IN2
rep1_TCCGGAGATAAGGCGATCGACTAGTATAGCCT	IN1
rep1_AGCGATAGCTCTCTACAAGGAGTACAGGACGT	EX3
rep1_TCCGCGAACGATCAGTAAGGCTATATAGAGGC	EX2
rep1_CGCTCATTGCTCATGATTATGCGAATAGAGGC	AC
rep1_GAGATTCCCGTACTAGCGTCTAATCCTATCCT	EX3
rep1_GAGATTCCGGAGCTACAAGGAGTACAGGACGT	IN2
rep1_GAGATTCCGCGTAGTAGAGCCTTATATAGCCT	OC
rep1_AGCGATAGACTGAGCGGTAAGGAGCAGGACGT	IN1
rep1_CTGAAGCTAAGAGGCACGTCTAATGGCTCTGA	OC
rep1_AGCGATAGGGAGCTACTTATGCGATATAGCCT	EX3
rep1_TCCGGAGAACTGAGCGAAGGAGTAGGCTCTGA	EX3
rep1_AGCGATAGGGACTCCTAAGGCTATATAGAGGC	OC
rep1_GAGATTCCCTCTCTACTTATGCGAATAGAGGC	OC
rep1_TAATGCGCTAGGCATGGAGCCTTATATAGCCT	EX3
rep1_ATTACTCGTCGACGTCCTCTCTATTATAGCCT	EX2
rep1_ATTACTCGGGAGCTACGCGTAAGACAGGACGT	EX1
rep1_ATTACTCGCGTACTAGGCGTAAGATATAGCCT	EX3
rep1_AGCGATAGCCTAAGACGAGCCTTATATAGCCT	IN2
rep1_GAGATTCCGGAGCTACTCGACTAGCAGGACGT	OC
rep1_CGCTCATTCGATCAGTTATCCTCTATAGAGGC	EX2
rep1_CGGCTATGAAGAGGCATTATGCGACCTATCCT	EX3
rep1_CGGCTATGATCTCAGGTTCTAGCTATAGAGGC	EX2
rep1_GAGATTCCTACGCTGCCTCTCTATTATAGCCT	IN2
rep1_AGCGATAGGGACTCCTTCTCTCCGATAGAGGC	IN1
rep1_ATTACTCGATCTCAGGGTAAGGAGGGCTCTGA	AC
rep1_AGCGATAGTACGCTGCTTATGCGAATAGAGGC	OC
rep1_CGCTCATTTCGACGTCACTGCATACCTATCCT	EX3
rep1_TCCGCGAAGCGTAGTATATCCTCTATAGAGGC	MG
rep1_AGCGATAGCGAGGCTGCTAAGCCTTATAGCCT	EX3
rep1_CGGCTATGCTCTGGTATTATGCGATATAGCCT	EX3
rep1_TCCGCGAAGGACTCCTTCTCTCCGTATAGCCT	EX1
rep1_ATTACTCGTAGCGCTCCGTCTAATATAGAGGC	OC
rep1_GAGATTCCGGAGCTACTATCCTCTCAGGACGT	EX1
rep1_ATTACTCGTACGCTGCCTCTCTATTATAGCCT	EX3
rep1_CTGAAGCTCCTAAGACACTGCATACCTATCCT	EX2
rep1_ATTACTCGTAAGGCGAGCGTAAGACAGGACGT	EX3
rep1_ATTCAGAAACTCGCTATTCTAGCTCCTATCCT	IN2
rep1_CTGAAGCTTAGCGCTCTTCTAGCTATAGAGGC	EX3
rep1_AGCGATAGTGCAGCTATCGACTAGATAGAGGC	IN2
rep1_CGCTCATTTCGACGTCCCTAGAGTATAGAGGC	EX3
rep1_CGCTCATTGTAGAGGACCTAGAGTCCTATCCT	EX1
rep1_CGCTCATTACTCGCTACTCTCTATCAGGACGT	EX1
rep1_CGGCTATGAGGCAGAAAAGGCTATATAGAGGC	EX2
rep1_CGGCTATGAAGAGGCAAAGGAGTACAGGACGT	EX3
rep1_TCCGGAGAACTCGCTAGCGTAAGACCTATCCT	EX3
rep1_CGCTCATTTAGCGCTCAAGGAGTACCTATCCT	EX3
rep1_CGGCTATGTACGCTGCATCTGAGTTATAGCCT	IN2
rep1_CGGCTATGGCTCATGACCTAGAGTATAGAGGC	EX3
rep1_CGGCTATGAAGAGGCATTATGCGAATAGAGGC	IN2
rep1_CGGCTATGTGCAGCTACGTCTAATCAGGACGT	EX2
rep1_AGCGATAGCTCTCTACGCGTAAGATATAGCCT	EX1
rep1_AGCGATAGAAGAGGCAGTAAGGAGCAGGACGT	EX3
rep1_AGCGATAGGGACTCCTTCTCTCCGCAGGACGT	OC
rep1_CGGCTATGTCGACGTCTCGACTAGCAGGACGT	IN1
rep1_CGCTCATTTCCTGAGCTTATGCGACAGGACGT	IN1
rep1_ATTCAGAACTCTGGTACTAAGCCTCCTATCCT	EX3
rep1_CGGCTATGTAGGCATGCGTCTAATCAGGACGT	OC
rep1_TCCGGAGACGTACTAGGTAAGGAGGGCTCTGA	IN2
rep1_GAGATTCCCGAGGCTGTATCCTCTCAGGACGT	OC
rep1_CGCTCATTACTCGCTACTAAGCCTCCTATCCT	EX3
rep1_CGGCTATGTACGCTGCCCTAGAGTATAGAGGC	IN1
rep1_ATTACTCGAGGCAGAATTATGCGATATAGCCT	IN2
rep1_GAGATTCCATCTCAGGTTCTAGCTCCTATCCT	EX2
rep1_CTGAAGCTTCGACGTCACTGCATAGGCTCTGA	IN2
rep1_ATTACTCGATCTCAGGACTGCATAGGCTCTGA	EX3
rep1_TCCGGAGATAAGGCGAACTGCATAATAGAGGC	EX3
rep1_CGCTCATTGGAGCTACGTAAGGAGATAGAGGC	EX3
rep1_CGGCTATGCGTACTAGATCTGAGTCAGGACGT	EX2
rep1_CTGAAGCTTAAGGCGACTAAGCCTATAGAGGC	OC
rep1_AGCGATAGAGGCAGAACCTAGAGTATAGAGGC	IN2
rep1_ATTACTCGCTCTCTACTCGACTAGTATAGCCT	MG
rep1_TCTCGCGCCTCTGGTAGTAAGGAGCAGGACGT	EX1
rep1_AGCGATAGTCCTGAGCTTATGCGACAGGACGT	IN1
rep1_AGCGATAGCTCTCTACAAGGAGTATATAGCCT	EX2
rep1_GAGATTCCTACGCTGCATCTGAGTCAGGACGT	EX1
rep1_CTGAAGCTTAGCGCTCACTGCATACCTATCCT	IN1
rep1_CGCTCATTACTGAGCGAAGGAGTATATAGCCT	IN1
rep1_AGCGATAGTAGCGCTCTCGACTAGCCTATCCT	EX3
rep1_CGCTCATTATGCGCAGTATCCTCTGGCTCTGA	EX2
rep1_AGCGATAGTAGGCATGCTCTCTATATAGAGGC	EX3
rep1_CGCTCATTAGGCAGAACTAAGCCTTATAGCCT	IN2
rep1_AGCGATAGTAGCGCTCGCGTAAGACCTATCCT	MG
rep1_CGCTCATTCCTAAGACTTCTAGCTATAGAGGC	EX2
rep1_CGCTCATTGTAGAGGAGAGCCTTAATAGAGGC	IN2
rep1_CGGCTATGAGGCAGAATCGACTAGTATAGCCT	EX3
rep1_ATTCAGAAGTAGAGGATTATGCGACCTATCCT	IN2
rep1_AGCGATAGCCTAAGACAAGGCTATTATAGCCT	MG
rep1_TCCGGAGAGGACTCCTTCGACTAGATAGAGGC	IN2
rep1_TCCGGAGAGTAGAGGAAAGGAGTAGGCTCTGA	EX1
rep1_CTGAAGCTCTCTGGTACTAAGCCTTATAGCCT	MG
rep1_ATTACTCGGCGTAGTAATCTGAGTATAGAGGC	EX3
rep1_CTGAAGCTGCTCATGATATCCTCTCAGGACGT	EX2
rep1_ATTACTCGTACGCTGCCCTAGAGTTATAGCCT	EX1
rep1_AGCGATAGCGATCAGTCTCTCTATCAGGACGT	MG
rep1_ATTACTCGATGCGCAGATCTGAGTTATAGCCT	AC
rep1_ATTCAGAAACTGAGCGAAGGAGTACCTATCCT	IN1
rep1_GAGATTCCGGACTCCTTCTCTCCGTATAGCCT	AC
rep1_TCCGCGAAACTCGCTAGCGTAAGACAGGACGT	EX3
rep1_CTGAAGCTCGTACTAGCCTAGAGTATAGAGGC	AC
rep1_ATTCAGAATCGACGTCGAGCCTTACCTATCCT	EX3
rep1_CTGAAGCTTAGGCATGACTGCATACAGGACGT	EX2
rep1_TCCGGAGAACTCGCTACTCTCTATGGCTCTGA	EX1
rep1_CTGAAGCTAAGAGGCACTAAGCCTGGCTCTGA	AC
rep1_ATTCAGAATAAGGCGAAAGGCTATATAGAGGC	EX3
rep1_CTGAAGCTTAGCGCTCTCTCTCCGTATAGCCT	IN2
rep1_AGCGATAGACTCGCTAAAGGAGTACAGGACGT	EX3
rep1_TCCGGAGATCGACGTCCTCTCTATGGCTCTGA	EX3
rep1_ATTACTCGACTGAGCGCGTCTAATCCTATCCT	EX1
rep1_TCCGGAGATAGGCATGCCTAGAGTCAGGACGT	OC
rep1_AGCGATAGAGGCAGAAAAGGCTATCAGGACGT	OC
rep1_CGCTCATTGCTCATGAAAGGAGTAGGCTCTGA	AC
rep1_CGCTCATTAAGAGGCACTAAGCCTTATAGCCT	IN1
rep1_CGCTCATTAAGAGGCATCGACTAGCCTATCCT	EX3
rep1_TCCGGAGATAGCGCTCGTAAGGAGTATAGCCT	EX2
rep1_TCCGGAGATAGGCATGCTCTCTATGGCTCTGA	EX1
rep1_TCCGGAGAGCGTAGTAAAGGAGTACAGGACGT	EX3
rep1_GAGATTCCACTGAGCGATCTGAGTTATAGCCT	IN2
rep1_TCCGCGAAACTCGCTAATCTGAGTTATAGCCT	EX1
rep1_ATTACTCGTAGCGCTCGAGCCTTAATAGAGGC	AC
rep1_TCCGCGAAAGGCAGAATCGACTAGTATAGCCT	IN1
rep1_CGCTCATTTGCAGCTAAAGGAGTACAGGACGT	EX2
rep1_TCCGCGAATACGCTGCAAGGCTATATAGAGGC	EX2
rep1_CGGCTATGAGGCAGAAGAGCCTTATATAGCCT	IN2
rep1_CGGCTATGATGCGCAGGCGTAAGACAGGACGT	IN2
rep1_GAGATTCCACTGAGCGCCTAGAGTTATAGCCT	EX3
rep1_CTGAAGCTGTAGAGGACCTAGAGTCAGGACGT	MG
rep1_AGCGATAGGGACTCCTGAGCCTTACAGGACGT	EX3
rep1_CTGAAGCTCTCTGGTATTCTAGCTATAGAGGC	MG
rep1_CTGAAGCTTAAGGCGATTATGCGATATAGCCT	EX3
rep1_AGCGATAGTAGCGCTCTTATGCGAATAGAGGC	OC
rep1_CGCTCATTTCGACGTCGCGTAAGAGGCTCTGA	EX3
rep1_CTGAAGCTGTAGAGGAGAGCCTTAGGCTCTGA	EX3
rep1_TCCGGAGAACTCGCTATTATGCGATATAGCCT	OC
rep1_AGCGATAGTCGACGTCTCGACTAGCAGGACGT	OC
rep1_TCCGGAGACGAGGCTGCGTCTAATGGCTCTGA	IN2
rep1_CGCTCATTCGTACTAGCTAAGCCTATAGAGGC	EX1
rep1_CGGCTATGTCCTGAGCTTCTAGCTTATAGCCT	AC
rep1_CGGCTATGTGCAGCTATCGACTAGATAGAGGC	EX1
rep1_CGCTCATTCTCTGGTAGAGCCTTAATAGAGGC	EX2
rep1_CGCTCATTTCCTGAGCGTAAGGAGCAGGACGT	IN2
rep1_TCCGGAGACGTACTAGATCTGAGTGGCTCTGA	IN2
rep1_TCCGGAGAAGGCAGAAATCTGAGTTATAGCCT	IN2
rep1_TCCGGAGAACTCGCTAGAGCCTTACAGGACGT	IN2
rep1_GAGATTCCGCTCATGACGTCTAATTATAGCCT	IN1
rep1_TCCGGAGACGATCAGTTCGACTAGGGCTCTGA	EX3
rep1_AGCGATAGTAAGGCGAGTAAGGAGCAGGACGT	IN1
rep1_AGCGATAGCGTACTAGGCGTAAGATATAGCCT	OC
rep1_TCCGCGAAGGAGCTACACTGCATATATAGCCT	IN2
rep1_ATTACTCGCGATCAGTGTAAGGAGTATAGCCT	AC
rep1_CTGAAGCTTCCTGAGCGAGCCTTAATAGAGGC	AC
rep1_CGCTCATTAAGAGGCATATCCTCTTATAGCCT	IN1
rep1_GAGATTCCCTCTGGTACGTCTAATTATAGCCT	IN2
rep1_GAGATTCCATCTCAGGCTCTCTATCAGGACGT	OC
rep1_CGCTCATTACTCGCTAGAGCCTTATATAGCCT	EX3
rep1_CGCTCATTCGATCAGTGAGCCTTAATAGAGGC	EX1
rep1_GAGATTCCATCTCAGGGAGCCTTAGGCTCTGA	IN1
rep1_CTGAAGCTCGAGGCTGGAGCCTTATATAGCCT	MG
rep1_CGGCTATGCGATCAGTTTATGCGAATAGAGGC	IN1
rep1_TCCGCGAACGATCAGTAAGGCTATGGCTCTGA	EX3
rep1_CGGCTATGGGAGCTACACTGCATACCTATCCT	EX3
rep1_ATTCAGAACGAGGCTGCTAAGCCTCAGGACGT	IN1
rep1_TCCGGAGAGTAGAGGAAAGGAGTATATAGCCT	EX3
rep1_ATTACTCGCCTAAGACATCTGAGTTATAGCCT	IN2
rep1_TCCGGAGAGCTCATGATTCTAGCTTATAGCCT	IN1
rep1_GAGATTCCTGCAGCTACTCTCTATATAGAGGC	EX3
rep1_CGGCTATGAAGAGGCAACTGCATAGGCTCTGA	EX3
rep1_CTGAAGCTTAGCGCTCAAGGAGTACAGGACGT	IN2
rep1_GAGATTCCACTGAGCGACTGCATAGGCTCTGA	EX3
rep1_AGCGATAGGGACTCCTGAGCCTTATATAGCCT	OC
rep1_CGCTCATTGGAGCTACTTCTAGCTCCTATCCT	EX3
rep1_AGCGATAGCGAGGCTGACTGCATAATAGAGGC	OC
rep1_TCCGGAGATGCAGCTACGTCTAATCAGGACGT	EX3
rep1_TCCGCGAATCCTGAGCCTCTCTATTATAGCCT	EX2
rep1_ATTACTCGCTCTCTACCGTCTAATTATAGCCT	EX2
rep1_CGCTCATTTCCTGAGCATCTGAGTCAGGACGT	AC
rep1_ATTCAGAATGCAGCTATATCCTCTCCTATCCT	EX2
rep1_TCCGGAGATAAGGCGATCGACTAGCAGGACGT	EX2
rep1_TCCGGAGAGTAGAGGAACTGCATACAGGACGT	EX3
rep1_CGGCTATGTACGCTGCTCGACTAGGGCTCTGA	OC
rep1_CGCTCATTTAAGGCGAGAGCCTTATATAGCCT	EX2
rep1_CTGAAGCTACTGAGCGCTAAGCCTCAGGACGT	IN1
rep1_CTGAAGCTTAGCGCTCGAGCCTTAATAGAGGC	MG
rep1_CTGAAGCTCGTACTAGTTATGCGAGGCTCTGA	IN2
rep1_CGGCTATGGCGTAGTACGTCTAATTATAGCCT	IN2
rep1_TCCGCGAATGCAGCTATTATGCGATATAGCCT	EX3
rep1_CGCTCATTTAAGGCGATTCTAGCTCAGGACGT	EX1
rep1_CTGAAGCTGCGTAGTACTCTCTATATAGAGGC	EX1
rep1_TCCGGAGAGCGTAGTACTAAGCCTTATAGCCT	IN2
rep1_ATTACTCGTAAGGCGATTCTAGCTTATAGCCT	EX3
rep1_CGGCTATGCGTACTAGGAGCCTTACAGGACGT	EX3
rep1_CGCTCATTCCTAAGACACTGCATACCTATCCT	MG
rep1_AGCGATAGTCCTGAGCTTCTAGCTATAGAGGC	IN1
rep1_TCCGGAGACTCTGGTAGAGCCTTACCTATCCT	IN2
rep1_CTGAAGCTCGATCAGTCTAAGCCTGGCTCTGA	IN2
rep1_CTGAAGCTTAGGCATGTCGACTAGGGCTCTGA	IN2
rep1_CTGAAGCTCTCTGGTACTCTCTATTATAGCCT	EX1
rep1_CGCTCATTACTGAGCGAAGGCTATATAGAGGC	EX3
rep1_TCCGGAGACGAGGCTGGTAAGGAGTATAGCCT	MG
rep1_AGCGATAGCTCTGGTAACTGCATATATAGCCT	EX3
rep1_CTGAAGCTCTCTGGTACTAAGCCTATAGAGGC	IN2
rep1_AGCGATAGATCTCAGGCTAAGCCTTATAGCCT	EX1
rep1_AGCGATAGGTAGAGGAAAGGCTATCAGGACGT	OC
rep1_ATTACTCGAAGAGGCAAAGGCTATGGCTCTGA	OC
rep1_GAGATTCCGCTCATGAACTGCATAGGCTCTGA	MG
rep1_GAGATTCCTAGCGCTCGAGCCTTACCTATCCT	IN1
rep1_TCCGGAGACGAGGCTGCCTAGAGTATAGAGGC	EX3
rep1_AGCGATAGGCGTAGTACGTCTAATTATAGCCT	AC
rep1_GAGATTCCCGAGGCTGCGTCTAATATAGAGGC	OC
rep1_ATTCAGAAAAGAGGCAAAGGAGTACAGGACGT	IN1
rep1_CGCTCATTTCGACGTCCGTCTAATGGCTCTGA	OC
rep1_ATTACTCGCGAGGCTGTATCCTCTTATAGCCT	OC
rep1_AGCGATAGGCTCATGAAAGGCTATCAGGACGT	MG
rep1_AGCGATAGATCTCAGGCTAAGCCTATAGAGGC	IN2
rep1_CGGCTATGCTCTGGTACTAAGCCTGGCTCTGA	EX2
rep1_CGGCTATGGCGTAGTACCTAGAGTTATAGCCT	IN2
rep1_GAGATTCCATCTCAGGAAGGCTATTATAGCCT	OC
rep1_CTGAAGCTTCGACGTCATCTGAGTCCTATCCT	EX2
rep1_CGGCTATGCTCTCTACGCGTAAGAATAGAGGC	IN1
rep1_GAGATTCCAAGAGGCATTATGCGACCTATCCT	EX3
rep1_CGGCTATGACTGAGCGTATCCTCTCAGGACGT	IN2
rep1_GAGATTCCCGATCAGTATCTGAGTCAGGACGT	AC
rep1_TCCGGAGATCCTGAGCATCTGAGTTATAGCCT	EX3
rep1_CGCTCATTTAGGCATGGAGCCTTACAGGACGT	AC
rep1_GAGATTCCTCCTGAGCCCTAGAGTCAGGACGT	EX1
rep1_AGCGATAGCGAGGCTGTCGACTAGTATAGCCT	OC
rep1_CTGAAGCTCGAGGCTGAAGGCTATATAGAGGC	MG
rep1_CTGAAGCTTAGCGCTCCTAAGCCTGGCTCTGA	IN2
rep1_CTGAAGCTTAAGGCGACGTCTAATTATAGCCT	EX3
rep1_AGCGATAGTCGACGTCGTAAGGAGATAGAGGC	MG
rep1_CGGCTATGCTCTCTACAAGGAGTAATAGAGGC	EX1
rep1_CGCTCATTTGCAGCTAACTGCATACAGGACGT	AC
rep1_TCCGCGAAGGACTCCTCTCTCTATTATAGCCT	EX3
rep1_CTGAAGCTATCTCAGGCGTCTAATCAGGACGT	AC
rep1_ATTCAGAAGCGTAGTAAAGGCTATCCTATCCT	EX2
rep1_CGGCTATGTACGCTGCATCTGAGTGGCTCTGA	EX3
rep1_ATTACTCGGCGTAGTATTCTAGCTTATAGCCT	OC
rep1_CGCTCATTACTCGCTAAAGGAGTAGGCTCTGA	IN2
rep1_GAGATTCCTAGGCATGCTCTCTATCCTATCCT	EX2
rep1_TAATGCGCCGATCAGTGTAAGGAGTATAGCCT	EX3
rep1_CGGCTATGACTCGCTAAAGGAGTATATAGCCT	AC
rep1_TCCGGAGAATGCGCAGCTCTCTATGGCTCTGA	EX2
rep1_AGCGATAGCGAGGCTGTCTCTCCGTATAGCCT	EX3
rep1_GAGATTCCATGCGCAGCCTAGAGTTATAGCCT	EX3
rep1_GAGATTCCACTGAGCGGTAAGGAGATAGAGGC	IN2
rep1_CGGCTATGCTCTGGTACGTCTAATTATAGCCT	IN1
rep1_CGCTCATTTAGGCATGCTCTCTATTATAGCCT	EX3
rep1_GAGATTCCATGCGCAGGAGCCTTACAGGACGT	EX1
rep1_CTGAAGCTTAAGGCGACGTCTAATGGCTCTGA	IN1
rep1_TCCGGAGACCTAAGACTCGACTAGGGCTCTGA	EX3
rep1_CTGAAGCTGGAGCTACTCGACTAGCAGGACGT	EX3
rep1_AGCGATAGACTCGCTATCTCTCCGATAGAGGC	MG
rep1_GAGATTCCCTCTGGTACTAAGCCTCAGGACGT	IN2
rep1_ATTCAGAAAAGAGGCAATCTGAGTATAGAGGC	EX3
rep1_AGCGATAGTAGCGCTCGCGTAAGACAGGACGT	MG
rep1_CGCTCATTGGACTCCTTTCTAGCTTATAGCCT	IN2
rep1_ATTACTCGACTGAGCGATCTGAGTTATAGCCT	MG
rep1_ATTCAGAACGTACTAGACTGCATACCTATCCT	OC
rep1_GAGATTCCAGGCAGAACTCTCTATTATAGCCT	EX2
rep1_CGCTCATTCTCTCTACACTGCATAGGCTCTGA	EX3
rep1_ATTACTCGAGGCAGAAAAGGCTATTATAGCCT	EX3
rep1_TCCGGAGAAAGAGGCACGTCTAATCAGGACGT	IN2
rep1_CGGCTATGCTCTGGTATTATGCGACAGGACGT	EX2
rep1_CGGCTATGATCTCAGGTCGACTAGTATAGCCT	IN2
rep1_GAGATTCCCTCTCTACACTGCATACCTATCCT	EX2
rep1_GAGATTCCAAGAGGCACCTAGAGTCAGGACGT	EX2
rep1_CTGAAGCTGGAGCTACAAGGCTATATAGAGGC	IN2
rep1_CGCTCATTCTCTGGTAAAGGCTATCAGGACGT	EX2
rep1_TCCGGAGACTCTCTACGCGTAAGACAGGACGT	EX3
rep1_ATTCAGAATAGGCATGGCGTAAGACAGGACGT	EX3
rep1_CGGCTATGTCGACGTCATCTGAGTTATAGCCT	EX2
rep1_GAGATTCCTAGGCATGTTCTAGCTATAGAGGC	IN2
rep1_TCCGCGAACTCTCTACCTAAGCCTGGCTCTGA	EX3
rep1_GAGATTCCCGATCAGTCTAAGCCTCAGGACGT	IN2
rep1_AGCGATAGCGATCAGTCGTCTAATATAGAGGC	OC
rep1_AGCGATAGTAGCGCTCTATCCTCTCAGGACGT	OC
rep1_AGCGATAGACTGAGCGAAGGCTATCAGGACGT	MG
rep1_GAGATTCCGGAGCTACCTAAGCCTTATAGCCT	EX2
rep1_GAGATTCCATGCGCAGCCTAGAGTGGCTCTGA	EX3
rep1_GAGATTCCCTCTCTACTCTCTCCGTATAGCCT	IN2
rep1_AGCGATAGTAGGCATGAAGGCTATATAGAGGC	MG
rep1_TCCGCGAATCCTGAGCAAGGAGTACAGGACGT	EX3
rep1_CTGAAGCTACTCGCTAAAGGCTATATAGAGGC	MG
rep1_ATTCAGAATCCTGAGCGCGTAAGACCTATCCT	IN2
rep1_ATTACTCGTCGACGTCTTATGCGATATAGCCT	AC
rep1_CTGAAGCTTAGGCATGACTGCATAATAGAGGC	IN1
rep1_TCCGCGAACTCTCTACTTCTAGCTATAGAGGC	EX2
rep1_GAGATTCCTAGCGCTCCTCTCTATATAGAGGC	OC
rep1_CGCTCATTTCCTGAGCTATCCTCTCCTATCCT	EX3
rep1_CGGCTATGCGTACTAGGAGCCTTAATAGAGGC	IN2
rep1_CGGCTATGGGAGCTACGCGTAAGAATAGAGGC	IN1
rep1_CGGCTATGGCGTAGTATTCTAGCTTATAGCCT	IN1
rep1_CGCTCATTTCGACGTCCTAAGCCTATAGAGGC	EX2
rep1_ATTCAGAATCCTGAGCAAGGAGTACAGGACGT	EX2
rep1_GAGATTCCTAGCGCTCACTGCATAATAGAGGC	EX2
rep1_CTGAAGCTGCTCATGAAAGGAGTAATAGAGGC	OC
rep1_TCCGGAGAAAGAGGCATTCTAGCTCCTATCCT	AC
rep1_ATTCAGAAAAGAGGCAGCGTAAGAATAGAGGC	EX2
rep1_CTGAAGCTTAGCGCTCGCGTAAGAATAGAGGC	IN1
rep1_TCCGGAGAAAGAGGCAAAGGCTATCAGGACGT	IN2
rep1_GAGATTCCCGTACTAGATCTGAGTTATAGCCT	EX2
rep1_TCCGGAGACGATCAGTACTGCATATATAGCCT	EX1
rep1_ATTACTCGGTAGAGGAAAGGAGTAGGCTCTGA	IN2
rep1_GAGATTCCAAGAGGCACGTCTAATCAGGACGT	OC
rep1_CGCTCATTATCTCAGGCTCTCTATCCTATCCT	AC
rep1_ATTACTCGTAAGGCGAGTAAGGAGTATAGCCT	IN1
rep1_ATTCAGAATAGCGCTCAAGGAGTACCTATCCT	EX2
rep1_CGCTCATTCGTACTAGAAGGCTATCAGGACGT	IN2
rep1_TAATGCGCGGAGCTACCCTAGAGTTATAGCCT	IN2
rep1_CGCTCATTCGAGGCTGCGTCTAATGGCTCTGA	IN2
rep1_TCCGGAGAAAGAGGCAATCTGAGTTATAGCCT	IN2
rep1_TCCGGAGAACTCGCTATTCTAGCTGGCTCTGA	OC
rep1_ATTCAGAAATCTCAGGGAGCCTTACAGGACGT	EX3
rep1_CTGAAGCTGCGTAGTATCGACTAGTATAGCCT	EX2
rep1_ATTCAGAACTCTCTACTTATGCGAATAGAGGC	EX3
rep1_ATTCAGAAGGACTCCTCCTAGAGTTATAGCCT	EX3
rep1_CTGAAGCTCTCTCTACAAGGCTATGGCTCTGA	EX3
rep1_ATTACTCGATCTCAGGCTAAGCCTTATAGCCT	IN2
rep1_TCCGCGAAGTAGAGGAGAGCCTTACAGGACGT	EX1
rep1_CGGCTATGACTGAGCGAAGGAGTATATAGCCT	OC
rep1_TCCGCGAACCTAAGACATCTGAGTCAGGACGT	EX2
rep1_AGCGATAGATGCGCAGGCGTAAGAATAGAGGC	IN2
rep1_CGGCTATGACTCGCTAGCGTAAGACCTATCCT	OC
rep1_TCCGGAGAACTGAGCGAAGGAGTACAGGACGT	IN2
rep1_TCCGCGAAGGACTCCTAAGGAGTAGGCTCTGA	AC
rep1_CGCTCATTCGAGGCTGTTCTAGCTGGCTCTGA	EX1
rep1_GAGATTCCCTCTCTACCCTAGAGTCCTATCCT	IN2
rep1_CGCTCATTGTAGAGGACGTCTAATCCTATCCT	EX3
rep1_CTGAAGCTGCGTAGTAAAGGAGTAATAGAGGC	IN2
rep1_CGCTCATTCTCTGGTAATCTGAGTCCTATCCT	EX1
rep1_CGCTCATTGTAGAGGAAAGGAGTACCTATCCT	EX3
rep1_ATTCAGAATCGACGTCGCGTAAGACAGGACGT	MG
rep1_CTGAAGCTCGAGGCTGCTAAGCCTCAGGACGT	OC
rep1_AGCGATAGTCGACGTCGAGCCTTATATAGCCT	OC
rep1_ATTCAGAAACTGAGCGTCGACTAGCCTATCCT	EX1
rep1_TCCGGAGAGGAGCTACCTCTCTATTATAGCCT	IN1
rep1_CTGAAGCTACTGAGCGGAGCCTTATATAGCCT	IN2
rep1_ATTCAGAATGCAGCTACCTAGAGTCCTATCCT	IN2
rep1_CGGCTATGCTCTGGTACTCTCTATTATAGCCT	AC
rep1_AGCGATAGGTAGAGGAGCGTAAGACAGGACGT	EX3
rep1_CGGCTATGGGAGCTACCCTAGAGTCCTATCCT	EX1
rep1_AGCGATAGTGCAGCTATATCCTCTCAGGACGT	OC
rep1_CGCTCATTCGTACTAGACTGCATACAGGACGT	EX3
rep1_CGCTCATTTGCAGCTACTCTCTATCCTATCCT	IN2
rep1_TCCGGAGATAAGGCGAAAGGCTATCCTATCCT	EX3
rep1_ATTACTCGACTGAGCGTTATGCGAATAGAGGC	IN2
rep1_GAGATTCCCGATCAGTAAGGAGTATATAGCCT	OC
rep1_AGCGATAGCGTACTAGTTATGCGAATAGAGGC	EX1
rep1_TCCGGAGACGTACTAGTTATGCGACCTATCCT	IN2
rep1_CTGAAGCTCGTACTAGAAGGAGTATATAGCCT	EX2
rep1_CGCTCATTTCGACGTCATCTGAGTCCTATCCT	MG
rep1_TCCGGAGAGCGTAGTAATCTGAGTGGCTCTGA	EX2
rep1_AGCGATAGCGATCAGTTTCTAGCTATAGAGGC	EX3
rep1_CGGCTATGTAAGGCGATTCTAGCTCCTATCCT	EX2
rep1_CTGAAGCTATCTCAGGTTCTAGCTCAGGACGT	EX2
rep1_CGCTCATTACTCGCTATATCCTCTCAGGACGT	EX3
rep1_CGGCTATGGCTCATGAGTAAGGAGATAGAGGC	IN2
rep1_TCCGGAGATCGACGTCGAGCCTTATATAGCCT	EX3
rep1_ATTACTCGACTCGCTACCTAGAGTGGCTCTGA	IN2
rep1_CGCTCATTGCTCATGATTCTAGCTCCTATCCT	EX3
rep1_TCCGCGAAGCTCATGAATCTGAGTGGCTCTGA	OC
rep1_GAGATTCCTAGCGCTCCGTCTAATATAGAGGC	MG
rep1_CGCTCATTGCGTAGTAAAGGAGTAATAGAGGC	EX3
rep1_CGGCTATGCGTACTAGCTAAGCCTCAGGACGT	OC
rep1_TCCGGAGATAGCGCTCCCTAGAGTCCTATCCT	EX1
rep1_CTGAAGCTCGAGGCTGAAGGCTATGGCTCTGA	AC
rep1_TCCGGAGAATCTCAGGGCGTAAGAATAGAGGC	IN2
rep1_TCCGGAGACGAGGCTGAAGGAGTAGGCTCTGA	EX1
rep1_ATTACTCGCTCTCTACAAGGAGTATATAGCCT	EX1
rep1_CGCTCATTACTGAGCGCTCTCTATATAGAGGC	EX3
rep1_CGGCTATGATGCGCAGGAGCCTTACCTATCCT	AC
rep1_GAGATTCCAAGAGGCAATCTGAGTTATAGCCT	IN1
rep1_GAGATTCCTCGACGTCACTGCATAATAGAGGC	EX3
rep1_CTGAAGCTATGCGCAGAAGGAGTACAGGACGT	MG
rep1_TCCGGAGATGCAGCTAGTAAGGAGTATAGCCT	EX3
rep1_CGGCTATGAAGAGGCAGCGTAAGAGGCTCTGA	EX2
rep1_TCCGGAGAATCTCAGGGAGCCTTACAGGACGT	IN2
rep1_CGGCTATGTCGACGTCGCGTAAGACAGGACGT	IN2
rep1_ATTCAGAATCCTGAGCCGTCTAATCCTATCCT	EX2
rep1_AGCGATAGCCTAAGACTTATGCGACAGGACGT	IN2
rep1_ATTCAGAATCGACGTCCGTCTAATCCTATCCT	EX3
rep1_CTGAAGCTTGCAGCTAGCGTAAGACAGGACGT	IN1
rep1_CGCTCATTACTCGCTAGCGTAAGACAGGACGT	IN2
rep1_ATTCAGAAGGAGCTACATCTGAGTCAGGACGT	EX3
rep1_GAGATTCCGCGTAGTATATCCTCTCAGGACGT	OC
rep1_GAGATTCCGGAGCTACAAGGCTATCCTATCCT	OC
rep1_GAGATTCCTAGGCATGATCTGAGTCCTATCCT	EX3
rep1_GAGATTCCGTAGAGGAGCGTAAGACAGGACGT	OC
rep1_ATTACTCGATCTCAGGCGTCTAATATAGAGGC	IN2
rep1_CGCTCATTAAGAGGCATTCTAGCTCCTATCCT	OC
rep1_CGCTCATTGGACTCCTCTAAGCCTCCTATCCT	MG
rep1_GAGATTCCCGAGGCTGCTAAGCCTGGCTCTGA	EX1
rep1_ATTACTCGTAGGCATGGAGCCTTATATAGCCT	EX2
rep1_CGCTCATTATCTCAGGTCGACTAGCCTATCCT	EX2
rep1_GAGATTCCAAGAGGCATATCCTCTCAGGACGT	OC
rep1_CGCTCATTCGATCAGTTTATGCGACAGGACGT	AC
rep1_GAGATTCCCGTACTAGTATCCTCTTATAGCCT	OC
rep1_CGGCTATGTCGACGTCTCGACTAGCCTATCCT	EX1
rep1_ATTACTCGGGAGCTACAAGGCTATCCTATCCT	EX1
rep1_AGCGATAGCGATCAGTCCTAGAGTATAGAGGC	IN2
rep1_ATTCAGAACGAGGCTGTCTCTCCGCCTATCCT	IN1
rep1_GAGATTCCGTAGAGGAGTAAGGAGGGCTCTGA	AC
rep1_CGGCTATGTCCTGAGCTTCTAGCTATAGAGGC	IN1
rep1_CTGAAGCTCCTAAGACCGTCTAATCAGGACGT	EX1
rep1_CTGAAGCTGCGTAGTAAAGGCTATATAGAGGC	IN2
rep1_AGCGATAGCGTACTAGTTCTAGCTTATAGCCT	IN2
rep1_CGGCTATGTACGCTGCTCTCTCCGTATAGCCT	IN1
rep1_AGCGATAGGCTCATGAAAGGAGTATATAGCCT	EX3
rep1_ATTACTCGTCGACGTCTTATGCGAATAGAGGC	EX2
rep1_TCCGCGAAATGCGCAGCGTCTAATCAGGACGT	EX1
rep1_TCCGGAGATAGCGCTCGTAAGGAGGGCTCTGA	IN2
rep1_CGCTCATTGCTCATGAGAGCCTTACAGGACGT	MG
rep1_GAGATTCCGTAGAGGATCGACTAGATAGAGGC	MG
rep1_TCCGCGAAATCTCAGGTCTCTCCGCAGGACGT	EX3
rep1_TCCGGAGATAGCGCTCCCTAGAGTATAGAGGC	MG
rep1_CTGAAGCTTAAGGCGAACTGCATATATAGCCT	EX3
rep1_CGCTCATTCGATCAGTCTAAGCCTTATAGCCT	EX3
rep1_ATTACTCGTCCTGAGCAAGGCTATTATAGCCT	EX1
rep1_AGCGATAGATCTCAGGTCGACTAGCAGGACGT	EX2
rep1_CTGAAGCTCTCTGGTATATCCTCTATAGAGGC	AC
rep1_TCCGGAGATAGGCATGGTAAGGAGCCTATCCT	EX3
rep1_ATTACTCGATGCGCAGTCTCTCCGCAGGACGT	EX1
rep1_ATTCAGAATACGCTGCTCTCTCCGCCTATCCT	IN1
rep1_ATTCAGAAAGGCAGAATTATGCGACAGGACGT	AC
rep1_CGGCTATGATCTCAGGACTGCATAGGCTCTGA	EX2
rep1_ATTCAGAAAAGAGGCATTATGCGACCTATCCT	EX3
rep1_CGGCTATGCTCTCTACACTGCATAATAGAGGC	MG
rep1_ATTACTCGAAGAGGCAAAGGCTATTATAGCCT	EX3
rep1_AGCGATAGGCGTAGTATCGACTAGCAGGACGT	AC
rep1_TCCGGAGACGAGGCTGGCGTAAGACCTATCCT	MG
rep1_CGGCTATGCTCTGGTAGCGTAAGATATAGCCT	OC
rep1_CGCTCATTCGATCAGTTATCCTCTCCTATCCT	EX2
rep1_GAGATTCCCTCTGGTATTCTAGCTTATAGCCT	IN2
rep1_CGGCTATGAAGAGGCATTATGCGATATAGCCT	EX2
rep1_GAGATTCCTAGGCATGCTAAGCCTCAGGACGT	EX3
rep1_ATTCAGAATAGCGCTCTCGACTAGCAGGACGT	EX3
rep1_GAGATTCCTCCTGAGCACTGCATACCTATCCT	EX3
rep1_TCCGGAGATCGACGTCTCTCTCCGGGCTCTGA	EX1
rep1_TCCGGAGACTCTGGTAGTAAGGAGTATAGCCT	OC
rep1_CGCTCATTCGTACTAGCTCTCTATGGCTCTGA	IN2
rep1_CGCTCATTTGCAGCTAGAGCCTTATATAGCCT	OC
rep1_ATTACTCGGCGTAGTAAAGGCTATCCTATCCT	EX2
rep1_TCCGGAGATCCTGAGCTCTCTCCGTATAGCCT	MG
rep1_TCCGGAGATAGCGCTCTATCCTCTCAGGACGT	AC
rep1_GAGATTCCTGCAGCTACGTCTAATATAGAGGC	IN2
rep1_CGCTCATTTACGCTGCAAGGCTATTATAGCCT	EX2
rep1_TCCGCGAAATGCGCAGCCTAGAGTCCTATCCT	EX2
rep1_CTGAAGCTCCTAAGACCTAAGCCTGGCTCTGA	EX3
rep1_ATTACTCGTCGACGTCCTCTCTATGGCTCTGA	EX3
rep1_CTGAAGCTCGATCAGTCTCTCTATCAGGACGT	EX2
rep1_TCCGGAGAAGGCAGAAATCTGAGTGGCTCTGA	IN2
rep1_TCCGGAGAAGGCAGAATCGACTAGGGCTCTGA	IN2
rep1_ATTACTCGCTCTCTACTTATGCGACAGGACGT	EX2
rep1_GAGATTCCGGAGCTACATCTGAGTCCTATCCT	OC
rep1_AGCGATAGCGATCAGTCTAAGCCTATAGAGGC	EX2
rep1_AGCGATAGTACGCTGCTCTCTCCGCAGGACGT	IN2
rep1_GAGATTCCTAGCGCTCAAGGAGTATATAGCCT	IN2
rep1_TCCGCGAAAGGCAGAATTCTAGCTTATAGCCT	EX2
rep1_CGGCTATGCTCTCTACACTGCATACCTATCCT	AC
rep1_ATTCAGAACTCTGGTACTAAGCCTTATAGCCT	IN1
rep1_CTGAAGCTAGGCAGAAAAGGAGTAATAGAGGC	IN2
rep1_AGCGATAGACTGAGCGTTATGCGAATAGAGGC	IN2
rep1_AGCGATAGTAAGGCGACTCTCTATATAGAGGC	OC
rep1_AGCGATAGCCTAAGACGTAAGGAGTATAGCCT	MG
rep1_ATTACTCGAAGAGGCATATCCTCTTATAGCCT	OC
rep1_GAGATTCCTAGCGCTCCTAAGCCTCAGGACGT	AC
rep1_GAGATTCCATGCGCAGGCGTAAGACCTATCCT	IN1
rep1_ATTACTCGCGAGGCTGCTCTCTATTATAGCCT	EX2
rep1_GAGATTCCCGTACTAGTCGACTAGTATAGCCT	IN2
rep1_CGGCTATGAGGCAGAAATCTGAGTCCTATCCT	OC
rep1_ATTACTCGCGAGGCTGAAGGAGTATATAGCCT	EX1
rep1_CGCTCATTATCTCAGGTATCCTCTCAGGACGT	IN2
rep1_CGGCTATGGGAGCTACTCGACTAGATAGAGGC	IN2
rep1_ATTACTCGACTCGCTAATCTGAGTTATAGCCT	IN1
rep1_CGGCTATGTGCAGCTATTATGCGATATAGCCT	OC
rep1_TCCGGAGATAAGGCGAGAGCCTTACAGGACGT	IN2
rep1_CGGCTATGGTAGAGGATTCTAGCTATAGAGGC	EX3
rep1_TCCGCGAAGTAGAGGAGAGCCTTAATAGAGGC	EX3
rep1_CGCTCATTACTCGCTACGTCTAATCAGGACGT	IN1
rep1_AGCGATAGTAGCGCTCGTAAGGAGATAGAGGC	IN1
rep1_GAGATTCCCGAGGCTGTCGACTAGGGCTCTGA	EX3
rep1_CTGAAGCTACTCGCTATCGACTAGATAGAGGC	EX1
rep1_CTGAAGCTAGGCAGAAGCGTAAGATATAGCCT	EX2
rep1_CGGCTATGATGCGCAGAAGGAGTATATAGCCT	OC
rep1_CGGCTATGTCGACGTCCCTAGAGTCAGGACGT	EX1
rep1_CTGAAGCTTCCTGAGCAAGGCTATATAGAGGC	IN2
rep1_TCCGGAGAGGACTCCTCTCTCTATCAGGACGT	AC
rep1_CGGCTATGCGAGGCTGTTCTAGCTATAGAGGC	IN2
rep1_GAGATTCCGCTCATGATTCTAGCTCCTATCCT	EX3
rep1_ATTCAGAAGCGTAGTAATCTGAGTCCTATCCT	EX3
rep1_ATTACTCGACTGAGCGCTCTCTATTATAGCCT	IN2
rep1_ATTACTCGTAGGCATGGCGTAAGAATAGAGGC	AC
rep1_CGCTCATTATGCGCAGTATCCTCTTATAGCCT	OC
rep1_GAGATTCCACTCGCTAACTGCATAGGCTCTGA	EX3
rep1_GAGATTCCGCGTAGTAATCTGAGTCCTATCCT	IN2
rep1_CTGAAGCTGCGTAGTACCTAGAGTGGCTCTGA	EX3
rep1_ATTACTCGGCTCATGATTATGCGATATAGCCT	IN2
rep1_ATTACTCGACTGAGCGCGTCTAATATAGAGGC	IN2
rep1_ATTACTCGGCTCATGACTAAGCCTCAGGACGT	EX2
rep1_TCCGGAGATACGCTGCTATCCTCTCAGGACGT	EX3
rep1_ATTACTCGATGCGCAGTTATGCGACAGGACGT	EX1
rep1_CTGAAGCTTAGGCATGCCTAGAGTCAGGACGT	OC
rep1_TCCGGAGAGGAGCTACTCGACTAGGGCTCTGA	EX3
rep1_TCCGGAGAATCTCAGGTCGACTAGTATAGCCT	OC
rep1_ATTCAGAACGTACTAGAAGGCTATATAGAGGC	EX3
rep1_ATTCAGAATAGGCATGACTGCATAATAGAGGC	EX3
rep1_CGGCTATGCGAGGCTGACTGCATATATAGCCT	IN2
rep1_CGCTCATTCGATCAGTATCTGAGTCCTATCCT	EX2
rep1_CTGAAGCTTACGCTGCTCGACTAGGGCTCTGA	IN2
rep1_GAGATTCCCTCTGGTAATCTGAGTCAGGACGT	MG
rep1_GAGATTCCGCTCATGAGTAAGGAGATAGAGGC	OC
rep1_TCCGCGAATAAGGCGATCGACTAGATAGAGGC	IN1
rep1_GAGATTCCAAGAGGCACGTCTAATATAGAGGC	OC
rep1_TCCGGAGATGCAGCTAGAGCCTTAGGCTCTGA	IN2
rep1_ATTCAGAACGAGGCTGGCGTAAGACCTATCCT	MG
rep1_TCCGGAGAGCTCATGATCTCTCCGCAGGACGT	EX1
rep1_CGGCTATGTACGCTGCAAGGCTATTATAGCCT	EX2
rep1_TCCGGAGATAAGGCGAAAGGAGTATATAGCCT	AC
rep1_GAGATTCCCGTACTAGCCTAGAGTCCTATCCT	EX3
rep1_ATTACTCGCGTACTAGTCGACTAGCAGGACGT	AC
rep1_CGGCTATGTACGCTGCTTATGCGACCTATCCT	EX3
rep1_GAGATTCCCCTAAGACTTCTAGCTATAGAGGC	IN1
rep1_CGGCTATGAGGCAGAAAAGGAGTAATAGAGGC	IN1
rep1_AGCGATAGAAGAGGCACTAAGCCTCAGGACGT	IN2
rep1_GAGATTCCATGCGCAGTCGACTAGTATAGCCT	MG
rep1_TAATGCGCAGGCAGAACTCTCTATCAGGACGT	EX2
rep1_ATTACTCGTAGGCATGTATCCTCTATAGAGGC	IN2
rep1_CTGAAGCTATCTCAGGGCGTAAGAGGCTCTGA	AC
rep1_CGCTCATTCCTAAGACTCGACTAGGGCTCTGA	AC
rep1_GAGATTCCTGCAGCTACTAAGCCTCAGGACGT	OC
rep1_TCCGGAGACTCTCTACACTGCATAATAGAGGC	EX1
rep1_TCCGGAGAGTAGAGGATTATGCGACCTATCCT	IN1
rep1_CGGCTATGCTCTCTACCTAAGCCTTATAGCCT	OC
rep1_CTGAAGCTCGAGGCTGAAGGAGTATATAGCCT	EX2
rep1_GAGATTCCTAAGGCGACCTAGAGTCAGGACGT	OC
rep1_GAGATTCCGGAGCTACGCGTAAGACAGGACGT	OC
rep1_CGCTCATTCGTACTAGACTGCATAGGCTCTGA	EX1
rep1_CGGCTATGTGCAGCTAAAGGCTATATAGAGGC	IN2
rep1_CGGCTATGCCTAAGACCCTAGAGTATAGAGGC	IN1
rep1_TCCGGAGACTCTGGTAGTAAGGAGGGCTCTGA	OC
rep1_TCCGCGAAATCTCAGGGTAAGGAGTATAGCCT	OC
rep1_AGCGATAGAGGCAGAACTCTCTATATAGAGGC	IN2
rep1_ATTACTCGCCTAAGACCTCTCTATCCTATCCT	EX3
rep1_ATTCAGAAGTAGAGGAAAGGAGTACCTATCCT	EX3
rep1_CTGAAGCTATGCGCAGTCGACTAGGGCTCTGA	EX2
rep1_TCCGGAGAATCTCAGGGAGCCTTACCTATCCT	AC
rep1_CTGAAGCTTAGGCATGCCTAGAGTTATAGCCT	EX1
rep1_GAGATTCCGCGTAGTAGAGCCTTAATAGAGGC	AC
rep1_CGGCTATGGCTCATGATCGACTAGCAGGACGT	IN2
rep1_GAGATTCCCTCTCTACTATCCTCTATAGAGGC	EX3
rep1_TCCGGAGATACGCTGCCCTAGAGTTATAGCCT	OC
rep1_CGCTCATTCGATCAGTAAGGCTATATAGAGGC	EX2
rep1_TCCGGAGATAGGCATGTATCCTCTTATAGCCT	EX3
rep1_TCCGGAGAGGAGCTACACTGCATAATAGAGGC	MG
rep1_TCCGCGAACGAGGCTGTCTCTCCGCAGGACGT	EX3
rep1_ATTACTCGTAAGGCGACTCTCTATATAGAGGC	EX2
rep1_ATTCAGAATCGACGTCCTAAGCCTCCTATCCT	AC
rep1_AGCGATAGGCGTAGTATTATGCGATATAGCCT	EX1
rep1_CGCTCATTCCTAAGACAAGGAGTATATAGCCT	EX3
rep1_TCCGGAGATACGCTGCGCGTAAGACCTATCCT	AC
rep1_GAGATTCCTGCAGCTATTCTAGCTGGCTCTGA	EX2
rep1_GAGATTCCGGAGCTACTCGACTAGATAGAGGC	OC
rep1_AGCGATAGGCGTAGTAGTAAGGAGCCTATCCT	EX3
rep1_ATTCAGAAGCTCATGATCGACTAGGGCTCTGA	EX2
rep1_GAGATTCCGCTCATGACCTAGAGTATAGAGGC	OC
rep1_GAGATTCCGCTCATGAATCTGAGTTATAGCCT	AC
rep1_TCCGCGAATCGACGTCGTAAGGAGGGCTCTGA	EX2
rep1_CGCTCATTAAGAGGCACTCTCTATCAGGACGT	IN2
rep1_CTGAAGCTACTCGCTACGTCTAATGGCTCTGA	EX3
rep1_ATTACTCGACTCGCTAACTGCATATATAGCCT	OC
rep1_CTGAAGCTTAGGCATGCTAAGCCTGGCTCTGA	IN2
rep1_ATTCAGAATAGGCATGATCTGAGTATAGAGGC	EX3
rep1_CGGCTATGTCCTGAGCTCGACTAGCAGGACGT	IN2
rep1_AGCGATAGTAAGGCGATTCTAGCTCAGGACGT	OC
rep1_CTGAAGCTCTCTCTACAAGGAGTACAGGACGT	AC
rep1_ATTCAGAATAGCGCTCACTGCATACCTATCCT	IN1
rep1_CTGAAGCTACTCGCTAGAGCCTTAGGCTCTGA	OC
rep1_TCCGGAGAGGAGCTACTATCCTCTTATAGCCT	IN1
rep1_TCCGGAGAATGCGCAGCTAAGCCTTATAGCCT	IN2
rep1_TAATGCGCCTCTGGTAACTGCATACAGGACGT	EX2
rep1_CGCTCATTTAGCGCTCGAGCCTTACAGGACGT	EX2
rep1_AGCGATAGGCTCATGATCGACTAGCCTATCCT	IN2
rep1_CGCTCATTGGACTCCTATCTGAGTCAGGACGT	EX2
rep1_GAGATTCCGGAGCTACCCTAGAGTGGCTCTGA	IN2
rep1_GAGATTCCTCGACGTCCTCTCTATGGCTCTGA	OC
rep1_ATTCAGAACTCTCTACCCTAGAGTTATAGCCT	IN2
rep1_TCCGGAGAGCTCATGAAAGGCTATGGCTCTGA	OC
rep1_TCCGGAGATCCTGAGCCGTCTAATTATAGCCT	IN2
rep1_ATTCAGAATAGCGCTCAAGGAGTACAGGACGT	EX1
rep1_CGGCTATGTAGGCATGCTCTCTATTATAGCCT	IN1
rep1_TCCGGAGATACGCTGCTCTCTCCGTATAGCCT	MG
rep1_GAGATTCCCGAGGCTGGCGTAAGAGGCTCTGA	IN2
rep1_TCCGGAGAGTAGAGGAATCTGAGTCAGGACGT	MG
rep1_ATTACTCGAGGCAGAATCGACTAGTATAGCCT	OC
rep1_CGCTCATTCGATCAGTCTCTCTATGGCTCTGA	EX3
rep1_GAGATTCCTAGCGCTCTCGACTAGCCTATCCT	MG
rep1_CGGCTATGGGAGCTACTATCCTCTTATAGCCT	AC
rep1_TCCGGAGAGCTCATGACCTAGAGTCCTATCCT	EX3
rep1_GAGATTCCCGTACTAGCTAAGCCTCAGGACGT	EX2
rep1_TCCGCGAAACTGAGCGCCTAGAGTTATAGCCT	IN2
rep1_GAGATTCCCGATCAGTACTGCATATATAGCCT	OC
rep1_CGCTCATTTGCAGCTACTAAGCCTCAGGACGT	OC
rep1_TCCGGAGATCGACGTCCTAAGCCTCCTATCCT	EX2
rep1_ATTACTCGCTCTGGTAACTGCATACCTATCCT	IN2
rep1_TCCGCGAACGTACTAGGTAAGGAGGGCTCTGA	IN1
rep1_CGCTCATTGGAGCTACTATCCTCTCCTATCCT	EX2
rep1_CGCTCATTACTCGCTAATCTGAGTCCTATCCT	MG
rep1_CGGCTATGCTCTGGTATCTCTCCGTATAGCCT	OC
rep1_GAGATTCCAAGAGGCAAAGGCTATTATAGCCT	OC
rep1_CGGCTATGAAGAGGCACGTCTAATCCTATCCT	EX2
rep1_CTGAAGCTCGAGGCTGTCTCTCCGATAGAGGC	IN2
rep1_CGCTCATTCCTAAGACCGTCTAATATAGAGGC	EX3
rep1_CGCTCATTAGGCAGAACCTAGAGTTATAGCCT	MG
rep1_TCCGGAGACTCTGGTAGCGTAAGAATAGAGGC	IN2
rep1_CGGCTATGTCGACGTCAAGGCTATTATAGCCT	AC
rep1_ATTACTCGTAGCGCTCTATCCTCTATAGAGGC	EX3
rep1_GAGATTCCTAGCGCTCTTATGCGATATAGCCT	IN2
rep1_CTGAAGCTGGACTCCTCCTAGAGTATAGAGGC	OC
rep1_ATTCAGAAGCGTAGTATCTCTCCGCAGGACGT	IN2
rep1_GAGATTCCTAAGGCGAAAGGCTATATAGAGGC	EX3
rep1_CGCTCATTGCGTAGTACGTCTAATTATAGCCT	AC
rep1_CTGAAGCTATGCGCAGATCTGAGTATAGAGGC	OC
rep1_CTGAAGCTGCGTAGTACTAAGCCTTATAGCCT	AC
rep1_TCCGCGAAGCGTAGTAAAGGAGTACAGGACGT	EX2
rep1_GAGATTCCCGTACTAGTCTCTCCGTATAGCCT	IN2
rep1_ATTACTCGCGTACTAGTATCCTCTTATAGCCT	EX3
rep1_ATTACTCGCTCTGGTATCGACTAGTATAGCCT	EX3
rep1_TCCGGAGAGCGTAGTATTCTAGCTTATAGCCT	IN2
rep1_ATTACTCGTAGCGCTCCCTAGAGTTATAGCCT	IN2
rep1_GAGATTCCTAAGGCGAGTAAGGAGTATAGCCT	OC
rep1_TCCGGAGAAAGAGGCATCGACTAGTATAGCCT	OC
rep1_CGGCTATGTCGACGTCCGTCTAATGGCTCTGA	EX2
rep1_CTGAAGCTGGACTCCTATCTGAGTATAGAGGC	IN2
rep1_TCCGGAGACGAGGCTGACTGCATAAGGCGAAG	IN2
rep1_TCCGGAGAACTGAGCGAAGGAGTAATAGAGGC	OC
rep1_AGCGATAGTCCTGAGCCCTAGAGTCCTATCCT	OC
rep1_CGCTCATTTACGCTGCTATCCTCTTATAGCCT	IN2
rep1_GAGATTCCGCTCATGACTCTCTATATAGAGGC	MG
rep1_CTGAAGCTTACGCTGCTCGACTAGCAGGACGT	OC
rep1_CTGAAGCTACTGAGCGAAGGCTATCAGGACGT	MG
rep1_CTGAAGCTCTCTCTACAAGGCTATTATAGCCT	AC
rep1_CGCTCATTCGAGGCTGCGTCTAATCAGGACGT	MG
rep1_CTGAAGCTTAGGCATGCCTAGAGTCCTATCCT	EX3
rep1_TCCGGAGATACGCTGCTCGACTAGCCTATCCT	IN2
rep1_CGGCTATGTGCAGCTAGAGCCTTACAGGACGT	IN2
rep1_TCCGGAGAACTGAGCGTTCTAGCTGGCTCTGA	IN1
rep1_TCCGCGAACGTACTAGTCTCTCCGTATAGCCT	IN2
rep1_GAGATTCCATGCGCAGCTCTCTATCAGGACGT	MG
rep1_ATTACTCGTACGCTGCTCGACTAGTATAGCCT	OC
rep1_CGCTCATTCGTACTAGAAGGCTATTATAGCCT	OC
rep1_CTGAAGCTTAGCGCTCATCTGAGTCAGGACGT	OC
rep1_GAGATTCCCGAGGCTGTTATGCGACCTATCCT	EX3
rep1_CGGCTATGCGTACTAGCTAAGCCTGGCTCTGA	IN2
rep1_GAGATTCCACTCGCTAAAGGCTATCCTATCCT	OC
rep1_ATTACTCGGGACTCCTAAGGCTATTATAGCCT	IN1
rep1_AGCGATAGATCTCAGGCTAAGCCTCCTATCCT	IN2
rep1_GAGATTCCTCCTGAGCTCGACTAGGGCTCTGA	MG
rep1_ATTCAGAAATGCGCAGACTGCATACAGGACGT	IN2
rep1_CTGAAGCTTAGCGCTCCCTAGAGTCAGGACGT	IN2
rep1_ATTACTCGTGCAGCTAATCTGAGTATAGAGGC	IN2
rep1_ATTACTCGATGCGCAGTTCTAGCTTATAGCCT	OC
rep1_AGCGATAGGCTCATGAGCGTAAGATATAGCCT	IN1
rep1_CGCTCATTGGAGCTACAAGGCTATCCTATCCT	OC
rep1_TCCGCGAACGATCAGTTTCTAGCTCCTATCCT	EX3
rep1_TCCGCGAATAAGGCGATTCTAGCTCAGGACGT	EX3
rep1_TCCGGAGATACGCTGCTATCCTCTATAGAGGC	OC
rep1_AGCGATAGCCTAAGACAAGGAGTAATAGAGGC	IN2
rep1_TCCGCGAATCCTGAGCCTAAGCCTTATAGCCT	EX3
rep1_CTGAAGCTGTAGAGGATCTCTCCGTATAGCCT	EX3
rep1_ATTCAGAACGAGGCTGCGTCTAATATAGAGGC	OC
rep1_AGCGATAGTGCAGCTATATCCTCTCCTATCCT	EX3
rep1_CTGAAGCTCGTACTAGGTAAGGAGGGCTCTGA	OC
rep1_TAATGCGCATGCGCAGACTGCATAATAGAGGC	EX3
rep1_CTGAAGCTTAAGGCGAAAGGAGTACAGGACGT	EX2
rep1_ATTCAGAAGTAGAGGAAAGGAGTAATAGAGGC	IN1
rep1_ATTACTCGTCCTGAGCCTAAGCCTTATAGCCT	EX2
rep1_AGCGATAGCCTAAGACCCTAGAGTATAGAGGC	IN2
rep1_ATTCAGAAAGGCAGAATATCCTCTCCTATCCT	AC
rep1_ATTACTCGGTAGAGGAAAGGCTATTATAGCCT	IN2
rep1_CGGCTATGACTCGCTACGTCTAATATAGAGGC	MG
rep1_TCCGGAGATACGCTGCCGTCTAATGGCTCTGA	EX2
rep1_CGGCTATGCGTACTAGTATCCTCTATAGAGGC	EX3
rep1_ATTACTCGGGACTCCTTTATGCGAATAGAGGC	IN2
rep1_CTGAAGCTTAGGCATGCTAAGCCTCAGGACGT	MG
rep1_TAATGCGCGCTCATGAACTGCATAGGCTCTGA	IN2
rep1_CGGCTATGACTCGCTATCGACTAGGGCTCTGA	MG
rep1_GAGATTCCACTCGCTATCGACTAGGGCTCTGA	IN2
rep1_CTGAAGCTCGAGGCTGTCTCTCCGTATAGCCT	EX2
rep1_GAGATTCCATGCGCAGCCTAGAGTCCTATCCT	OC
rep1_CGCTCATTGGACTCCTAAGGAGTATATAGCCT	IN2
rep1_TCCGGAGATACGCTGCCTCTCTATATAGAGGC	EX3
rep1_CGCTCATTGGAGCTACCCTAGAGTATAGAGGC	EX2
rep1_GAGATTCCAAGAGGCAAAGGAGTACAGGACGT	IN1
rep2_AGCGATAGTGCCAATTGGATACTATATAGCCT	EX3
rep2_AGCGATAGCAGAACTGTTGGAAGTCAGGACGT	EX3
rep2_GAGATTCCTATGGTCGTAAGATCCCAGGACGT	EX3
rep2_AGCGATAGACGTTCGATTGGAAGTCAGGACGT	EX3
rep2_AGCGATAGAAGCAACGTGCCTTACTATAGCCT	EX2
rep2_AGCGATAGCTTCAATGATTCGTTGTATAGCCT	EX2
rep2_AGCGATAGTATGCCATTTCATCCATATAGCCT	EX2
rep2_TCCGGAGAAAGCAACGATTCGTTGTATAGCCT	IN1
rep2_AGCGATAGTATGCCATATAGCCTTTATAGCCT	EX3
rep2_AGCGATAGTATGCCATCGAATTCCTATAGCCT	EX3
rep2_AGCGATAGACGTTCGAGGTTAGACATAGAGGC	EX1
rep2_AGCGATAGTATGCCATAGGATAACCAGGACGT	EX2
rep2_GAGATTCCATAAGTCGTAAGATCCTATAGCCT	EX2
rep2_AGCGATAGCTAATGCTTTGGAAGTTATAGCCT	EX3
rep2_AGCGATAGCTAATGCTAAGAGATGATAGAGGC	EX3
rep2_AGCGATAGTGCCAATTATTCGTTGCAGGACGT	EX2
rep2_CGGCTATGGAACGGTATTCATCCACAGGACGT	EX3
rep2_AGCGATAGGAACGGTAAAGAGATGTATAGCCT	EX2
rep2_TCCGGAGATTAGCCTCTGCCTTACTATAGCCT	EX2
rep2_GAGATTCCCGCTTGATTAAGATCCCAGGACGT	EX3
rep2_AGCGATAGGAATTACGAGGATAACCAGGACGT	EX3
rep2_AGCGATAGGAATTACGCGAATTCCATAGAGGC	EX2
rep2_AGCGATAGCAGAACTGATAGCCTTCAGGACGT	IN1
rep2_GAGATTCCTTAGCCTCATTCGTTGATAGAGGC	EX3
rep2_TCCGGAGACTTCAATGGGATACTACAGGACGT	EX3
rep2_GAGATTCCCTTCAATGCGAATTCCTATAGCCT	EX2
rep2_AGCGATAGGAATTACGTTGGAAGTCAGGACGT	EX3
rep2_GAGATTCCACGAATCTTGCCTTACATAGAGGC	EX3
rep2_AGCGATAGAAGCAACGAAGAGATGCAGGACGT	IN1
rep2_AGCGATAGGAATTACGAGGATAACTATAGCCT	EX3
rep2_AGCGATAGGCCTCAATTGCCTTACCAGGACGT	EX2
rep2_AGCGATAGTATGCCATGGATACTATATAGCCT	EX3
rep2_TCCGGAGAGAATTACGAGGATAACTATAGCCT	EX3
rep2_AGCGATAGGCCTCAATTGCCTTACATAGAGGC	EX1
rep2_AGCGATAGCAAGTTCATTGGAAGTATAGAGGC	EX3
rep2_TCCGGAGATATGCCATTAAGATCCCAGGACGT	EX3
rep2_GAGATTCCTATGGTCGTGCCTTACTATAGCCT	EX3
rep2_TCCGGAGACAAGTTCAAATGACGTTATAGCCT	IN1
rep2_AGCGATAGCTTCAATGCGAATTCCTATAGCCT	IN2
rep2_AGCGATAGAACCAGGTCGAATTCCCAGGACGT	EX3
rep2_GAGATTCCATAAGTCGTTGGAAGTCAGGACGT	EX3
rep2_CGCTCATTAACCAGGTTCCGGTAAGGCTCTGA	IN1
rep2_GAGATTCCTCTATCCGTTCATCCATATAGCCT	MG
rep2_GAGATTCCACGTTCGAGAAGTATGTATAGCCT	EX2
rep2_AGCGATAGTTAGCCTCTCCGGTAACAGGACGT	OC
rep2_GAGATTCCGAATTACGGAAGTATGTATAGCCT	EX2
rep2_AGCGATAGCTAATGCTTTACGACCTATAGCCT	EX3
rep2_GAGATTCCTGCCAATTGGATACTACAGGACGT	EX3
rep2_CGGCTATGCTTCAATGTTACGACCCAGGACGT	EX3
rep2_CGGCTATGATAAGTCGAAGAGATGCAGGACGT	EX2
rep2_CGCTCATTGCAACCTATAAGATCCTATAGCCT	EX3
rep2_AGCGATAGATAAGTCGCGAATTCCCAGGACGT	EX2
rep2_GAGATTCCCTTCAATGGGTTAGACATAGAGGC	EX3
rep2_CGCTCATTCTTCAATGAAGAGATGTATAGCCT	EX3
rep2_AGCGATAGTCTATCCGCGAATTCCCAGGACGT	EX3
rep2_TCCGGAGATACTGCCTGGATACTACAGGACGT	OC
rep2_AGCGATAGAAGCAACGTTACGACCTATAGCCT	EX3
rep2_CTGAAGCTGAACGGTATAAGATCCCAGGACGT	EX1
rep2_CTGAAGCTTACTGCCTAATGACGTCAGGACGT	EX2
rep2_GAGATTCCCTTCAATGTGCCTTACTATAGCCT	EX2
rep2_AGCGATAGACGAATCTAACGAACGATAGAGGC	EX2
rep2_TCCGGAGACTAATGCTAATGACGTATAGAGGC	EX3
rep2_CGCTCATTGTCTACCAATAGCCTTTATAGCCT	EX3
rep2_AGCGATAGCTTCAATGGGATACTACCTATCCT	EX3
rep2_CGGCTATGAAGCAACGGGATACTACAGGACGT	MG
rep2_GAGATTCCTCTATCCGAACGAACGCAGGACGT	EX3
rep2_GAGATTCCGAACGGTAATAGCCTTTATAGCCT	EX2
rep2_GAGATTCCTACTGCCTTCCGGTAATATAGCCT	IN1
rep2_AGCGATAGCAGAACTGGAAGTATGCAGGACGT	EX1
rep2_AGCGATAGATAAGTCGTCCGGTAACAGGACGT	EX3
rep2_AGCGATAGGTCATGAAGGTTAGACCAGGACGT	EX1
rep2_AGCGATAGGAATTACGCGAATTCCCCTATCCT	IN1
rep2_CTGAAGCTATAAGTCGTGCCTTACCAGGACGT	EX3
rep2_AGCGATAGCGCTTGATTTGGAAGTATAGAGGC	IN1
rep2_AGCGATAGGTCATGAAATTCGTTGTATAGCCT	EX2
rep2_CTGAAGCTTCTATCCGCGAATTCCCAGGACGT	EX2
rep2_CGCTCATTACGTTCGATCCGGTAATATAGCCT	EX2
rep2_TCCGGAGACTAATGCTTTCATCCAATAGAGGC	IN1
rep2_CGCTCATTAACCAGGTATAGCCTTTATAGCCT	EX3
rep2_ATTACTCGAACCAGGTATTCGTTGATAGAGGC	EX2
rep2_CTGAAGCTACGAATCTGGATACTAATAGAGGC	IN2
rep2_TCCGGAGAACGAATCTTCCGGTAAGGCTCTGA	EX3
rep2_CTGAAGCTTATGCCATATAGCCTTTATAGCCT	EX2
rep2_AGCGATAGCAGAACTGTCCGGTAAATAGAGGC	EX3
rep2_CGCTCATTTTCCATCCTTGGAAGTATAGAGGC	IN1
rep2_ATTCAGAAACGTTCGATTGGAAGTCAGGACGT	EX2
rep2_CGGCTATGCAGAACTGGAAGTATGCAGGACGT	IN1
rep2_AGCGATAGACGAATCTAGGATAACTATAGCCT	IN1
rep2_GAGATTCCCTAATGCTCGAATTCCCAGGACGT	EX2
rep2_CGGCTATGTTAGCCTCAATGACGTCAGGACGT	EX2
rep2_GAGATTCCGCAACCTAAATGACGTTATAGCCT	EX2
rep2_TCCGGAGAGAATTACGGGTTAGACCAGGACGT	EX3
rep2_GAGATTCCGAATTACGTTGGAAGTATAGAGGC	EX3
rep2_GAGATTCCCAAGTTCAAGGATAACTATAGCCT	IN1
rep2_AGCGATAGACGAATCTTGCCTTACTATAGCCT	EX3
rep2_AGCGATAGACGAATCTGGATACTATATAGCCT	EX3
rep2_CGGCTATGAAGCAACGTTCATCCACAGGACGT	EX3
rep2_AGCGATAGGCAACCTATTGGAAGTCAGGACGT	IN1
rep2_GAGATTCCTCTATCCGAGGATAACTATAGCCT	AC
rep2_ATTACTCGTGCCAATTTCCGGTAACAGGACGT	EX3
rep2_GAGATTCCGCAACCTATCCGGTAAATAGAGGC	OC
rep2_CGCTCATTGAACGGTATTCATCCAATAGAGGC	MG
rep2_GAGATTCCGAACGGTAAAGAGATGGGCTCTGA	EX3
rep2_TCCGGAGATTAGCCTCTTGGAAGTTATAGCCT	EX3
rep2_CGGCTATGGTCTACCAGAAGTATGCAGGACGT	EX2
rep2_CGCTCATTACGTTCGAGAAGTATGGGCTCTGA	EX2
rep2_AGCGATAGCGTATAGAGAAGTATGATAGAGGC	IN2
rep2_AGCGATAGCGTATAGACGAATTCCATAGAGGC	OC
rep2_TCCGGAGATGCCAATTATTCGTTGCAGGACGT	IN2
rep2_TCCGGAGACTTCAATGTTGGAAGTTATAGCCT	OC
rep2_AGCGATAGACGAATCTTTACGACCCAGGACGT	EX3
rep2_GAGATTCCGAATTACGAATGACGTTATAGCCT	EX2
rep2_AGCGATAGCAAGTTCAAAGAGATGATAGAGGC	EX1
rep2_CGCTCATTTTAGCCTCTTCATCCATATAGCCT	EX2
rep2_GAGATTCCTTAGCCTCTGCCTTACGGCTCTGA	EX2
rep2_TCCGGAGAAACCAGGTTGCCTTACCAGGACGT	IN1
rep2_TCCGCGAAATAAGTCGCGAATTCCTATAGCCT	IN1
rep2_CTGAAGCTCAGAACTGAATGACGTCAGGACGT	EX1
rep2_AGCGATAGATAAGTCGGGATACTAATAGAGGC	EX2
rep2_AGCGATAGGAATTACGTTCATCCAATAGAGGC	EX3
rep2_ATTACTCGGAATTACGAATGACGTCAGGACGT	EX3
rep2_TAATGCGCGCAACCTAGAAGTATGCCTATCCT	EX1
rep2_CGCTCATTCAGAACTGGAAGTATGTATAGCCT	EX3
rep2_GAGATTCCTTAGCCTCTCCGGTAACAGGACGT	EX2
rep2_CTGAAGCTTTAGCCTCTGCCTTACTATAGCCT	EX3
rep2_GAGATTCCTGCCAATTATTCGTTGCAGGACGT	OC
rep2_TCCGCGAATATGGTCGAGGATAACCAGGACGT	IN1
rep2_CGCTCATTGCCTCAATTGCCTTACTATAGCCT	IN2
rep2_AGCGATAGGTCATGAACGAATTCCCAGGACGT	EX1
rep2_CGGCTATGTACTGCCTAATGACGTTATAGCCT	OC
rep2_GAGATTCCTCTATCCGAAGAGATGCAGGACGT	EX3
rep2_CGGCTATGACGAATCTAAGAGATGTATAGCCT	EX2
rep2_CGCTCATTTGCCAATTTTCATCCAATAGAGGC	EX1
rep2_CGGCTATGACGTTCGATGCCTTACCAGGACGT	EX3
rep2_ATTACTCGTTCCATCCGGATACTACAGGACGT	EX3
rep2_GAGATTCCATAAGTCGTGCCTTACTATAGCCT	EX1
rep2_TCCGGAGAGTCATGAAAATGACGTCAGGACGT	EX2
rep2_GAGATTCCCGTATAGATCCGGTAAATAGAGGC	IN1
rep2_TCCGGAGACGTATAGAAGGATAACATAGAGGC	EX2
rep2_GAGATTCCCGTATAGATTGGAAGTGGCTCTGA	EX3
rep2_CGGCTATGGAATTACGTCCGGTAACAGGACGT	EX1
rep2_AGCGATAGTGCCAATTCGAATTCCTATAGCCT	EX3
rep2_TCCGGAGAGAACGGTAGAAGTATGGGCTCTGA	IN1
rep2_AGCGATAGGTCATGAAGAAGTATGATAGAGGC	AC
rep2_AGCGATAGTGCCAATTGGATACTACAGGACGT	IN1
rep2_CTGAAGCTGTCATGAATTCATCCACAGGACGT	EX3
rep2_CGCTCATTAACCAGGTAGGATAACTATAGCCT	IN1
rep2_AGCGATAGGCCTCAATATTCGTTGTATAGCCT	EX3
rep2_GAGATTCCCGCTTGATTTACGACCGGCTCTGA	IN2
rep2_CGCTCATTTTAGCCTCTTGGAAGTCAGGACGT	EX2
rep2_GAGATTCCCGCTTGATAACGAACGCAGGACGT	EX3
rep2_CGGCTATGTTCCATCCTTACGACCTATAGCCT	IN2
rep2_CGCTCATTTGCCAATTGGATACTATATAGCCT	EX3
rep2_TCCGGAGATGCCAATTGGTTAGACTATAGCCT	OC
rep2_GAGATTCCGTCTACCAAGGATAACTATAGCCT	EX3
rep2_GAGATTCCCAAGTTCATTCATCCATATAGCCT	EX3
rep2_CGCTCATTGAACGGTAATTCGTTGTATAGCCT	EX1
rep2_GAGATTCCTGCCAATTTGCCTTACTATAGCCT	EX3
rep2_GAGATTCCGCAACCTAGGTTAGACTATAGCCT	AC
rep2_CGCTCATTTTCCATCCATTCGTTGATAGAGGC	EX3
rep2_AGCGATAGGAACGGTATGCCTTACTATAGCCT	EX2
rep2_AGCGATAGTATGCCATTTGGAAGTTATAGCCT	EX1
rep2_CGCTCATTGAACGGTAAACGAACGGGCTCTGA	EX3
rep2_AGCGATAGACGAATCTGGATACTACAGGACGT	OC
rep2_TCCGGAGATATGCCATTTACGACCCAGGACGT	EX2
rep2_TCCGGAGACAGAACTGGGTTAGACGGCTCTGA	IN1
rep2_AGCGATAGCAAGTTCACGAATTCCTATAGCCT	IN2
rep2_CGCTCATTGTCTACCAGGATACTACAGGACGT	EX3
rep2_GAGATTCCAACCAGGTAGGATAACATAGAGGC	EX2
rep2_GAGATTCCTTAGCCTCGGTTAGACATAGAGGC	IN1
rep2_AGCGATAGAAGCAACGGGATACTAATAGAGGC	AC
rep2_CGCTCATTTCTATCCGAGGATAACTATAGCCT	OC
rep2_GAGATTCCAAGCAACGTTGGAAGTATAGAGGC	EX3
rep2_GAGATTCCATAAGTCGCGAATTCCATAGAGGC	IN2
rep2_AGCGATAGGTCTACCAGAAGTATGCAGGACGT	OC
rep2_CGCTCATTATAAGTCGGGTTAGACTATAGCCT	EX2
rep2_GAGATTCCTATGCCATTGCCTTACTATAGCCT	EX2
rep2_ATTCAGAATACTGCCTAATGACGTCAGGACGT	EX1
rep2_GAGATTCCCTTCAATGATAGCCTTCAGGACGT	IN2
rep2_AGCGATAGCAGAACTGTCCGGTAACAGGACGT	OC
rep2_TCCGCGAACAGAACTGATAGCCTTATAGAGGC	IN1
rep2_GAGATTCCTATGCCATATTCGTTGCAGGACGT	EX1
rep2_ATTACTCGGCCTCAATGGATACTACAGGACGT	EX1
rep2_TCCGCGAATGCCAATTGAAGTATGTATAGCCT	EX2
rep2_CTGAAGCTACGAATCTAAGAGATGCAGGACGT	EX2
rep2_AGCGATAGGCAACCTAGGATACTACCTATCCT	EX2
rep2_CGGCTATGTGCCAATTTAAGATCCCAGGACGT	EX2
rep2_CGGCTATGACGTTCGATTCATCCATATAGCCT	EX1
rep2_AGCGATAGCAAGTTCAGGATACTAATAGAGGC	EX2
rep2_TCCGGAGATATGGTCGATTCGTTGATAGAGGC	EX3
rep2_AGCGATAGCAAGTTCAGGTTAGACATAGAGGC	OC
rep2_CGGCTATGGTCTACCATCCGGTAATATAGCCT	EX3
rep2_ATTCAGAAGTCTACCAAAGAGATGCAGGACGT	EX2
rep2_GAGATTCCGAATTACGTTACGACCTATAGCCT	IN2
rep2_ATTACTCGTATGGTCGGAAGTATGCAGGACGT	EX3
rep2_AGCGATAGCGCTTGATCGAATTCCATAGAGGC	AC
rep2_AGCGATAGCGCTTGATAACGAACGCAGGACGT	MG
rep2_TCCGCGAAATAAGTCGTAAGATCCCAGGACGT	IN1
rep2_AGCGATAGGTCATGAAGGTTAGACTATAGCCT	AC
rep2_CTGAAGCTCGCTTGATCGAATTCCTATAGCCT	EX2
rep2_TCCGGAGACGCTTGATGGTTAGACCCTATCCT	IN1
rep2_AGCGATAGATAAGTCGTCCGGTAAATAGAGGC	EX3
rep2_AGCGATAGTTCCATCCTTGGAAGTATAGAGGC	IN1
rep2_CTGAAGCTTATGGTCGAATGACGTCAGGACGT	EX2
rep2_AGCGATAGGCCTCAATTTACGACCCAGGACGT	EX3
rep2_TCCGCGAATATGGTCGTTGGAAGTATAGAGGC	EX1
rep2_TCCGGAGACAGAACTGAATGACGTTATAGCCT	IN2
rep2_GAGATTCCGAACGGTAGAAGTATGTATAGCCT	EX3
rep2_TCCGCGAATTAGCCTCCGAATTCCGGCTCTGA	EX3
rep2_AGCGATAGGTCTACCAGGTTAGACATAGAGGC	MG
rep2_GAGATTCCGAACGGTAAGGATAACGGCTCTGA	IN1
rep2_ATTCAGAAAAGCAACGGGTTAGACCCTATCCT	EX3
rep2_GAGATTCCACGTTCGAGGATACTATATAGCCT	OC
rep2_TCCGCGAAGAACGGTAATAGCCTTATAGAGGC	EX3
rep2_AGCGATAGACGTTCGATTCATCCAATAGAGGC	OC
rep2_AGCGATAGCAAGTTCAGGTTAGACCCTATCCT	IN1
rep2_CGCTCATTAAGCAACGTTCATCCAGGCTCTGA	IN1
rep2_CTGAAGCTCAAGTTCAGAAGTATGCAGGACGT	EX2
rep2_AGCGATAGCAAGTTCAATAGCCTTCAGGACGT	EX3
rep2_CGGCTATGCAAGTTCATAAGATCCATAGAGGC	EX3
rep2_GAGATTCCACGTTCGATAAGATCCTATAGCCT	AC
rep2_GAGATTCCCAGAACTGGGATACTATATAGCCT	EX2
rep2_AGCGATAGATAAGTCGTTACGACCCAGGACGT	EX1
rep2_GAGATTCCTATGCCATTGCCTTACCAGGACGT	MG
rep2_AGCGATAGATAAGTCGGAAGTATGATAGAGGC	IN1
rep2_TCCGGAGAACGAATCTAATGACGTTATAGCCT	EX3
rep2_AGCGATAGCGTATAGATAAGATCCCAGGACGT	IN2
rep2_AGCGATAGCGCTTGATGGTTAGACCAGGACGT	IN2
rep2_TCCGGAGATATGCCATTCCGGTAAGGCTCTGA	EX1
rep2_TCCGGAGAGCCTCAATATTCGTTGATAGAGGC	IN1
rep2_TCCGGAGATTAGCCTCTAAGATCCATAGAGGC	EX3
rep2_TCCGGAGAAAGCAACGATTCGTTGCAGGACGT	EX2
rep2_GAGATTCCGCCTCAATATAGCCTTCAGGACGT	AC
rep2_AGCGATAGTTCCATCCAGGATAACTATAGCCT	OC
rep2_TCCGGAGATACTGCCTAACGAACGCAGGACGT	EX2
rep2_ATTACTCGCGCTTGATTTGGAAGTATAGAGGC	AC
rep2_TCCGGAGAATAAGTCGTTCATCCACAGGACGT	EX2
rep2_GAGATTCCTACTGCCTTAAGATCCTATAGCCT	MG
rep2_CGGCTATGGAACGGTAAACGAACGCAGGACGT	EX3
rep2_TCCGCGAACGTATAGAAACGAACGGGCTCTGA	EX3
rep2_CTGAAGCTTTAGCCTCTCCGGTAACAGGACGT	EX3
rep2_AGCGATAGAAGCAACGTTCATCCACAGGACGT	EX1
rep2_AGCGATAGTCTATCCGTTACGACCTATAGCCT	EX2
rep2_TAATGCGCTGCCAATTATAGCCTTTATAGCCT	MG
rep2_CTGAAGCTTTAGCCTCTAAGATCCCAGGACGT	IN1
rep2_TCCGGAGACTTCAATGATAGCCTTCAGGACGT	IN2
rep2_AGCGATAGATAAGTCGTTCATCCATATAGCCT	EX1
rep2_AGCGATAGATAAGTCGTTGGAAGTCAGGACGT	OC
rep2_CGGCTATGTATGGTCGGAAGTATGTATAGCCT	EX3
rep2_AGCGATAGCTTCAATGTTGGAAGTATAGAGGC	AC
rep2_AGCGATAGTGCCAATTTTACGACCATAGAGGC	OC
rep2_CGCTCATTTTAGCCTCGAAGTATGCAGGACGT	EX2
rep2_CGGCTATGTTCCATCCTCCGGTAACAGGACGT	EX3
rep2_ATTACTCGGCCTCAATCGAATTCCCAGGACGT	IN2
rep2_GAGATTCCTTAGCCTCAGGATAACCAGGACGT	AC
rep2_GAGATTCCGTCATGAAATAGCCTTCAGGACGT	EX2
rep2_AGCGATAGTCTATCCGATAGCCTTCAGGACGT	IN2
rep2_TCCGGAGACAAGTTCATCCGGTAAATAGAGGC	IN2
rep2_CGGCTATGGCCTCAATTGCCTTACTATAGCCT	EX2
rep2_GAGATTCCACGTTCGATTGGAAGTCAGGACGT	EX2
rep2_CGCTCATTCTTCAATGGGATACTACAGGACGT	EX2
rep2_ATTCAGAAGTCATGAAATTCGTTGCAGGACGT	EX2
rep2_GAGATTCCTGCCAATTTTCATCCACCTATCCT	EX2
rep2_CGGCTATGATAAGTCGGGATACTACAGGACGT	EX3
rep2_CGGCTATGGAATTACGATAGCCTTTATAGCCT	OC
rep2_CGGCTATGCAAGTTCAGAAGTATGCAGGACGT	OC
rep2_AGCGATAGCGTATAGATTACGACCATAGAGGC	EX3
rep2_TCCGCGAACTTCAATGGGTTAGACTATAGCCT	EX1
rep2_CTGAAGCTCGCTTGATGGTTAGACCAGGACGT	OC
rep2_CTGAAGCTAACCAGGTAACGAACGATAGAGGC	EX3
rep2_CGGCTATGTATGCCATGAAGTATGTATAGCCT	EX2
rep2_CTGAAGCTCAGAACTGTTGGAAGTGGCTCTGA	EX1
rep2_AGCGATAGAAGCAACGCGAATTCCCAGGACGT	IN2
rep2_TAATGCGCTATGCCATGGATACTATATAGCCT	IN1
rep2_TCCGGAGACAGAACTGAAGAGATGGGCTCTGA	EX2
rep2_GAGATTCCCGCTTGATAAGAGATGTATAGCCT	EX3
rep2_TCCGCGAATTAGCCTCTAAGATCCTATAGCCT	EX3
rep2_TCCGGAGATTAGCCTCTCCGGTAACAGGACGT	IN2
rep2_ATTACTCGTGCCAATTAATGACGTCAGGACGT	EX3
rep2_TCCGCGAATATGGTCGGGTTAGACCAGGACGT	IN1
rep2_TCCGGAGACAAGTTCAGGATACTAATAGAGGC	EX2
rep2_AGCGATAGACGAATCTTAAGATCCATAGAGGC	EX3
rep2_CTGAAGCTTATGGTCGTTGGAAGTCAGGACGT	EX2
rep2_ATTCAGAATGCCAATTATTCGTTGCAGGACGT	EX3
rep2_CGGCTATGCTAATGCTGGATACTATATAGCCT	OC
rep2_CGCTCATTGTCTACCAAGGATAACCAGGACGT	EX3
rep2_CGCTCATTGAACGGTAAATGACGTTATAGCCT	MG
rep2_CGCTCATTTCTATCCGAATGACGTTATAGCCT	IN1
rep2_TCCGGAGAGAATTACGGGATACTAATAGAGGC	EX2
rep2_AGCGATAGACGAATCTATTCGTTGCCTATCCT	IN2
rep2_AGCGATAGTTAGCCTCGGATACTAATAGAGGC	AC
rep2_TCCGGAGATGCCAATTAACGAACGCCTATCCT	EX3
rep2_TCCGGAGAGTCATGAATTCATCCACAGGACGT	EX2
rep2_TCCGGAGATTAGCCTCAACGAACGCCTATCCT	EX1
rep2_GAGATTCCAAGCAACGGGATACTATATAGCCT	OC
rep2_TCCGGAGATCTATCCGCGAATTCCTATAGCCT	IN1
rep2_AGCGATAGAAGCAACGAATGACGTCAGGACGT	MG
rep2_AGCGATAGTGCCAATTTGCCTTACCCTATCCT	EX3
rep2_CGCTCATTACGTTCGATAAGATCCATAGAGGC	IN1
rep2_GAGATTCCTATGCCATATAGCCTTATAGAGGC	IN2
rep2_CGCTCATTGCCTCAATCGAATTCCTATAGCCT	EX3
rep2_CGCTCATTGAACGGTATAAGATCCTATAGCCT	EX3
rep2_ATTCAGAATATGCCATAACGAACGCAGGACGT	EX2
rep2_CGCTCATTCTTCAATGAACGAACGCAGGACGT	AC
rep2_CGGCTATGACGAATCTTAAGATCCATAGAGGC	EX3
rep2_TCCGGAGAACGTTCGAAATGACGTCAGGACGT	IN1
rep2_ATTACTCGAACCAGGTATAGCCTTCAGGACGT	EX2
rep2_AGCGATAGATAAGTCGGGTTAGACATAGAGGC	MG
rep2_AGCGATAGTACTGCCTAGGATAACTATAGCCT	OC
rep2_CGGCTATGTACTGCCTTCCGGTAAATAGAGGC	EX3
rep2_CTGAAGCTACGAATCTATTCGTTGATAGAGGC	EX3
rep2_ATTCAGAATTCCATCCTCCGGTAACAGGACGT	MG
rep2_CGGCTATGCAGAACTGATTCGTTGTATAGCCT	EX2
rep2_GAGATTCCGAATTACGCGAATTCCGGCTCTGA	EX2
rep2_ATTACTCGCAGAACTGAAGAGATGCAGGACGT	EX2
rep2_AGCGATAGTATGGTCGTCCGGTAACCTATCCT	EX1
rep2_CGGCTATGTATGCCATTGCCTTACTATAGCCT	IN2
rep2_GAGATTCCCAGAACTGGGATACTACAGGACGT	IN1
rep2_TCCGGAGAGAATTACGATAGCCTTCAGGACGT	EX3
rep2_GAGATTCCCAGAACTGGGTTAGACCAGGACGT	EX3
rep2_TAATGCGCAAGCAACGAGGATAACCAGGACGT	OC
rep2_CGGCTATGGCAACCTATAAGATCCATAGAGGC	IN2
rep2_GAGATTCCCAGAACTGTTGGAAGTTATAGCCT	MG
rep2_GAGATTCCGTCTACCAAAGAGATGCAGGACGT	EX3
rep2_AGCGATAGTTCCATCCTTACGACCATAGAGGC	MG
rep2_AGCGATAGATAAGTCGGAAGTATGCAGGACGT	EX2
rep2_AGCGATAGTATGCCATTCCGGTAAATAGAGGC	EX1
rep2_AGCGATAGTATGCCATTAAGATCCATAGAGGC	EX1
rep2_ATTACTCGAACCAGGTTAAGATCCATAGAGGC	EX3
rep2_AGCGATAGACGTTCGATAAGATCCCAGGACGT	IN2
rep2_CTGAAGCTTATGCCATAACGAACGATAGAGGC	EX2
rep2_AGCGATAGTGCCAATTAAGAGATGCAGGACGT	MG
rep2_GAGATTCCCTTCAATGGGTTAGACTATAGCCT	OC
rep2_GAGATTCCGAACGGTAGGATACTACAGGACGT	OC
rep2_CTGAAGCTACGTTCGATCCGGTAACAGGACGT	MG
rep2_AGCGATAGGCCTCAATAGGATAACTATAGCCT	IN2
rep2_AGCGATAGTATGCCATAGGATAACCCTATCCT	IN2
rep2_CGGCTATGATAAGTCGTGCCTTACGGCTCTGA	EX3
rep2_TAATGCGCTGCCAATTTCCGGTAATATAGCCT	EX2
rep2_CGGCTATGCGTATAGATAAGATCCCAGGACGT	EX2
rep2_TCCGCGAATATGGTCGAATGACGTATAGAGGC	OC
rep2_TCCGGAGAGAATTACGTGCCTTACCAGGACGT	EX2
rep2_GAGATTCCCAAGTTCAGAAGTATGGGCTCTGA	EX2
rep2_ATTACTCGTATGGTCGTTCATCCACCTATCCT	EX2
rep2_TAATGCGCGCAACCTAAAGAGATGTATAGCCT	EX3
rep2_GAGATTCCTTCCATCCTCCGGTAACAGGACGT	MG
rep2_AGCGATAGTATGGTCGTAAGATCCATAGAGGC	IN2
rep2_TCCGGAGATATGCCATAATGACGTCAGGACGT	IN1
rep2_AGCGATAGTCTATCCGAATGACGTCAGGACGT	AC
rep2_CGGCTATGCGCTTGATGGATACTATATAGCCT	IN1
rep2_GAGATTCCCTAATGCTAAGAGATGTATAGCCT	MG
rep2_TCCGCGAAACGAATCTAAGAGATGATAGAGGC	EX2
rep2_CGGCTATGGTCTACCAGAAGTATGTATAGCCT	EX3
rep2_TCCGGAGAACGAATCTTAAGATCCCCTATCCT	EX3
rep2_TCCGGAGAAAGCAACGGAAGTATGCCTATCCT	EX3
rep2_CGCTCATTACGTTCGAAACGAACGTATAGCCT	IN1
rep2_TCCGGAGATTAGCCTCCGAATTCCTATAGCCT	EX3
rep2_TAATGCGCAAGCAACGATAGCCTTTATAGCCT	EX2
rep2_TCCGGAGATTAGCCTCATAGCCTTCAGGACGT	EX2
rep2_CGGCTATGCGTATAGAGGTTAGACTATAGCCT	EX2
rep2_ATTACTCGACGAATCTAAGAGATGATAGAGGC	IN1
rep2_GAGATTCCTTAGCCTCTTCATCCATATAGCCT	OC
rep2_CTGAAGCTAAGCAACGATAGCCTTCAGGACGT	EX3
rep2_TCCGGAGACGTATAGATTGGAAGTTATAGCCT	AC
rep2_AGCGATAGTATGGTCGAACGAACGCAGGACGT	OC
rep2_CGCTCATTAACCAGGTTTGGAAGTCAGGACGT	EX2
rep2_AGCGATAGACGTTCGAAATGACGTATAGAGGC	OC
rep2_CGGCTATGGCAACCTAATTCGTTGCAGGACGT	EX1
rep2_AGCGATAGGTCATGAAAATGACGTATAGAGGC	EX2
rep2_TCCGCGAACGCTTGATAACGAACGCAGGACGT	AC
rep2_AGCGATAGAACCAGGTTTACGACCCAGGACGT	OC
rep2_TCCGGAGAGAATTACGTGCCTTACTATAGCCT	IN1
rep2_GAGATTCCAACCAGGTAACGAACGTATAGCCT	OC
rep2_TCCGGAGAGAACGGTAAGGATAACTATAGCCT	OC
rep2_AGCGATAGTTCCATCCATTCGTTGCAGGACGT	OC
rep2_GAGATTCCATAAGTCGTTACGACCCAGGACGT	MG
rep2_TCCGCGAACAAGTTCATTCATCCACCTATCCT	EX1
rep2_TCCGGAGACAGAACTGTTACGACCTATAGCCT	IN2
rep2_AGCGATAGGAATTACGAATGACGTTATAGCCT	EX3
rep2_CTGAAGCTTTAGCCTCTTCATCCACAGGACGT	EX3
rep2_TCCGCGAACTAATGCTGAAGTATGCAGGACGT	EX1
rep2_CGCTCATTCAAGTTCATCCGGTAATATAGCCT	IN1
rep2_CGGCTATGACGTTCGATCCGGTAATATAGCCT	EX2
rep2_AGCGATAGGTCATGAAGGATACTATATAGCCT	OC
rep2_TCCGGAGATGCCAATTCGAATTCCTATAGCCT	IN2
rep2_ATTACTCGTTAGCCTCTTACGACCTATAGCCT	EX2
rep2_TCCGGAGAGCAACCTATTGGAAGTTATAGCCT	EX2
rep2_ATTCAGAACAAGTTCAGGTTAGACCCTATCCT	EX2
rep2_CTGAAGCTGTCTACCAGAAGTATGCAGGACGT	OC
rep2_GAGATTCCTTAGCCTCTCCGGTAAATAGAGGC	EX3
rep2_CGGCTATGTTCCATCCTTGGAAGTCAGGACGT	AC
rep2_AGCGATAGCAGAACTGTTACGACCATAGAGGC	EX2
rep2_GAGATTCCAACCAGGTGGATACTACAGGACGT	IN2
rep2_TCCGGAGAACGTTCGATAAGATCCTATAGCCT	IN1
rep2_CGGCTATGTCTATCCGAAGAGATGTATAGCCT	EX3
rep2_TCCGCGAACTAATGCTTGCCTTACCAGGACGT	EX3
rep2_TCCGCGAACAGAACTGTTCATCCAATAGAGGC	EX2
rep2_CGGCTATGGAACGGTACGAATTCCCAGGACGT	MG
rep2_ATTACTCGTACTGCCTAAGAGATGCAGGACGT	EX1
rep2_ATTACTCGGCCTCAATATTCGTTGCAGGACGT	EX2
rep2_ATTCAGAACGCTTGATAGGATAACCAGGACGT	EX1
rep2_AGCGATAGCGCTTGATTTCATCCACAGGACGT	IN2
rep2_CGGCTATGGCAACCTATCCGGTAACAGGACGT	IN2
rep2_CTGAAGCTTGCCAATTAAGAGATGATAGAGGC	IN2
rep2_GAGATTCCCAGAACTGTGCCTTACTATAGCCT	OC
rep2_ATTCAGAAGAACGGTAAAGAGATGCAGGACGT	IN2
rep2_AGCGATAGCTAATGCTATAGCCTTTATAGCCT	MG
rep2_TCCGGAGATCTATCCGAAGAGATGTATAGCCT	IN1
rep2_GAGATTCCTATGCCATAAGAGATGCAGGACGT	MG
rep2_AGCGATAGTACTGCCTTAAGATCCATAGAGGC	AC
rep2_TCCGCGAACTTCAATGTTCATCCACAGGACGT	EX1
rep2_CTGAAGCTTATGGTCGAATGACGTCCTATCCT	EX3
rep2_CGCTCATTGAACGGTATTCATCCATATAGCCT	IN1
rep2_AGCGATAGTGCCAATTTGCCTTACTATAGCCT	OC
rep2_AGCGATAGCGTATAGAAATGACGTATAGAGGC	OC
rep2_GAGATTCCGTCATGAAGAAGTATGATAGAGGC	EX3
rep2_ATTACTCGAAGCAACGAAGAGATGCAGGACGT	EX2
rep2_TCCGCGAATTCCATCCGGTTAGACTATAGCCT	IN1
rep2_CGGCTATGAAGCAACGGGTTAGACATAGAGGC	EX3
rep2_CGGCTATGATAAGTCGTGCCTTACTATAGCCT	EX3
rep2_GAGATTCCCGCTTGATTCCGGTAACAGGACGT	IN2
rep2_ATTACTCGTCTATCCGTTCATCCACCTATCCT	EX3
rep2_CTGAAGCTGCAACCTATTACGACCGGCTCTGA	EX1
rep2_TAATGCGCCAGAACTGTGCCTTACGGCTCTGA	EX2
rep2_TCCGGAGAGAACGGTAATAGCCTTATAGAGGC	IN2
rep2_CGCTCATTACGAATCTAACGAACGTATAGCCT	OC
rep2_GAGATTCCTTCCATCCAGGATAACCCTATCCT	MG
rep2_TCCGGAGATATGGTCGGAAGTATGCCTATCCT	AC
rep2_TCCGGAGACTAATGCTCGAATTCCATAGAGGC	EX1
rep2_CGGCTATGCTAATGCTATTCGTTGCAGGACGT	EX1
rep2_ATTACTCGTATGGTCGATTCGTTGTATAGCCT	EX2
rep2_TCCGCGAATTAGCCTCAGGATAACTATAGCCT	EX2
rep2_CTGAAGCTTTAGCCTCATAGCCTTATAGAGGC	EX2
rep2_CGCTCATTCGTATAGATTACGACCATAGAGGC	EX2
rep2_TCCGCGAAACGAATCTAATGACGTTATAGCCT	IN1
rep2_CTGAAGCTTCTATCCGTAAGATCCTATAGCCT	EX3
rep2_CGGCTATGGTCATGAATAAGATCCATAGAGGC	EX3
rep2_CGGCTATGTATGGTCGGAAGTATGATAGAGGC	EX2
rep2_CTGAAGCTTTCCATCCATAGCCTTCAGGACGT	IN1
rep2_ATTCAGAACAAGTTCAAACGAACGCCTATCCT	EX2
rep2_GAGATTCCGAATTACGGGATACTACAGGACGT	EX2
rep2_ATTACTCGTATGCCATGAAGTATGATAGAGGC	IN2
rep2_GAGATTCCTACTGCCTAACGAACGATAGAGGC	IN1
rep2_ATTCAGAAAACCAGGTAAGAGATGCAGGACGT	EX2
rep2_CGCTCATTTGCCAATTTAAGATCCTATAGCCT	EX2
rep2_GAGATTCCCGCTTGATTTCATCCATATAGCCT	IN1
rep2_CTGAAGCTCTAATGCTTTCATCCACAGGACGT	EX3
rep2_CGGCTATGCAGAACTGCGAATTCCCAGGACGT	IN1
rep2_CTGAAGCTACGTTCGAGGATACTATATAGCCT	EX1
rep2_TCCGGAGATCTATCCGCGAATTCCCAGGACGT	IN1
rep2_ATTACTCGACGAATCTTTGGAAGTCAGGACGT	IN1
rep2_CTGAAGCTCAAGTTCATTCATCCACAGGACGT	EX2
rep2_TCCGGAGATCTATCCGAATGACGTCCTATCCT	EX3
rep2_ATTCAGAACGTATAGAATAGCCTTATAGAGGC	OC
rep2_GAGATTCCGAATTACGTTCATCCAATAGAGGC	EX3
rep2_GAGATTCCACGTTCGAGAAGTATGCAGGACGT	OC
rep2_ATTACTCGCGCTTGATTAAGATCCTATAGCCT	EX3
rep2_CGCTCATTCGCTTGATGGTTAGACTATAGCCT	EX1
rep2_AGCGATAGGAATTACGAGGATAACCCTATCCT	IN1
rep2_CGCTCATTCTAATGCTGGATACTATATAGCCT	IN2
rep2_CGGCTATGGAATTACGTTACGACCTATAGCCT	EX3
rep2_AGCGATAGTATGGTCGGGTTAGACATAGAGGC	AC
rep2_CGGCTATGACGTTCGATAAGATCCATAGAGGC	IN1
rep2_AGCGATAGGTCTACCAAAGAGATGTATAGCCT	EX3
rep2_GAGATTCCTCTATCCGTCCGGTAATATAGCCT	OC
rep2_ATTCAGAATGCCAATTTTCATCCACCTATCCT	EX2
rep2_TCCGCGAACAAGTTCAAAGAGATGGGCTCTGA	EX2
rep2_AGCGATAGTCTATCCGTTGGAAGTTATAGCCT	IN2
rep2_ATTACTCGCTTCAATGATAGCCTTTATAGCCT	IN1
rep2_GAGATTCCTTCCATCCAGGATAACTATAGCCT	IN2
rep2_CTGAAGCTCGCTTGATTTCATCCACAGGACGT	EX1
rep2_CGGCTATGCTAATGCTAATGACGTATAGAGGC	IN2
rep2_CGGCTATGTCTATCCGTCCGGTAAATAGAGGC	EX3
rep2_CGCTCATTCTAATGCTATAGCCTTGGCTCTGA	EX2
rep2_CGCTCATTGAACGGTAATTCGTTGCAGGACGT	IN2
rep2_CTGAAGCTTACTGCCTAAGAGATGCAGGACGT	EX3
rep2_GAGATTCCAACCAGGTAATGACGTCAGGACGT	IN2
rep2_ATTACTCGACGAATCTTGCCTTACTATAGCCT	MG
rep2_TCCGGAGACTAATGCTATTCGTTGATAGAGGC	OC
rep2_ATTCAGAACGTATAGAGGATACTACCTATCCT	IN2
rep2_ATTCAGAAGAACGGTATTCATCCACAGGACGT	EX3
rep2_CTGAAGCTTTAGCCTCAATGACGTCAGGACGT	OC
rep2_ATTCAGAAGCCTCAATTGCCTTACCCTATCCT	EX2
rep2_TCCGCGAATATGCCATCGAATTCCCAGGACGT	EX3
rep2_CGCTCATTAAGCAACGTGCCTTACTATAGCCT	IN2
rep2_GAGATTCCCGTATAGATGCCTTACATAGAGGC	OC
rep2_ATTACTCGGAATTACGTGCCTTACCCTATCCT	EX3
rep2_GAGATTCCCAGAACTGAATGACGTATAGAGGC	IN1
rep2_GAGATTCCGAATTACGAAGAGATGCAGGACGT	IN2
rep2_GAGATTCCAACCAGGTAAGAGATGTATAGCCT	IN2
rep2_CGCTCATTCAGAACTGATTCGTTGATAGAGGC	EX3
rep2_TCCGCGAAGAATTACGGGATACTATATAGCCT	OC
rep2_GAGATTCCCGCTTGATTGCCTTACGGCTCTGA	EX1
rep2_AGCGATAGCGCTTGATAAGAGATGATAGAGGC	MG
rep2_ATTCAGAAGCAACCTAAACGAACGCCTATCCT	EX3
rep2_CGGCTATGCGTATAGAGGTTAGACCAGGACGT	EX2
rep2_TCCGCGAACGTATAGAGGTTAGACATAGAGGC	IN1
rep2_TCCGCGAACGCTTGATTCCGGTAAATAGAGGC	EX3
rep2_ATTCAGAAGCAACCTAGAAGTATGCCTATCCT	EX3
rep2_AGCGATAGCAAGTTCAGAAGTATGCCTATCCT	EX1
rep2_AGCGATAGGAATTACGATTCGTTGTATAGCCT	EX2
rep2_CTGAAGCTGAACGGTATTCATCCATATAGCCT	IN2
rep2_TCCGCGAAGCCTCAATTTACGACCATAGAGGC	EX3
rep2_TCCGGAGAGCAACCTATAAGATCCTATAGCCT	EX3
rep2_CTGAAGCTGTCTACCATTACGACCTATAGCCT	EX2
rep2_ATTACTCGATAAGTCGTTCATCCACAGGACGT	EX3
rep2_CTGAAGCTTCTATCCGAATGACGTGGCTCTGA	EX3
rep2_AGCGATAGCTAATGCTGAAGTATGTATAGCCT	EX3
rep2_ATTACTCGGTCTACCAAACGAACGCAGGACGT	EX2
rep2_TCCGCGAATCTATCCGTCCGGTAACAGGACGT	EX2
rep2_CGCTCATTGAACGGTATGCCTTACGGCTCTGA	IN1
rep2_CTGAAGCTTATGGTCGATTCGTTGTATAGCCT	IN2
rep2_CGGCTATGGAACGGTAATTCGTTGCAGGACGT	IN2
rep2_ATTACTCGCAAGTTCAGAAGTATGCAGGACGT	EX1
rep2_AGCGATAGTACTGCCTTTGGAAGTCAGGACGT	IN2
rep2_TCCGCGAAATAAGTCGTAAGATCCATAGAGGC	IN1
rep2_AGCGATAGGAACGGTATCCGGTAAATAGAGGC	MG
rep2_AGCGATAGTCTATCCGAACGAACGCAGGACGT	MG
rep2_CGGCTATGTATGGTCGCGAATTCCCAGGACGT	AC
rep2_CGGCTATGGTCTACCAAATGACGTCAGGACGT	EX2
rep2_ATTACTCGCGTATAGAAATGACGTTATAGCCT	AC
rep2_TAATGCGCGAATTACGAATGACGTATAGAGGC	EX3
rep2_CGGCTATGGCCTCAATAAGAGATGTATAGCCT	EX3
rep2_CGCTCATTCGTATAGAGGTTAGACTATAGCCT	EX3
rep2_TCCGCGAAGCAACCTATTCATCCACAGGACGT	EX3
rep2_TCCGGAGACGCTTGATTAAGATCCATAGAGGC	EX2
rep2_TAATGCGCCAAGTTCAAGGATAACCAGGACGT	EX1
rep2_TCCGGAGATATGGTCGTAAGATCCATAGAGGC	IN2
rep2_TCCGGAGACTAATGCTTTCATCCACAGGACGT	EX3
rep2_CGGCTATGGCCTCAATAGGATAACTATAGCCT	EX2
rep2_CTGAAGCTTACTGCCTGGTTAGACTATAGCCT	EX3
rep2_ATTACTCGTTCCATCCAAGAGATGCAGGACGT	EX2
rep2_ATTACTCGACGAATCTTTACGACCTATAGCCT	EX1
rep2_TCCGCGAAGTCATGAAAAGAGATGTATAGCCT	EX2
rep2_CTGAAGCTACGTTCGAAATGACGTCAGGACGT	IN1
rep2_TCCGCGAAGCAACCTATGCCTTACGGCTCTGA	EX2
rep2_CTGAAGCTGTCTACCAATAGCCTTATAGAGGC	EX3
rep2_CGCTCATTAACCAGGTAATGACGTATAGAGGC	IN2
rep2_TCCGCGAAAAGCAACGTAAGATCCCAGGACGT	EX3
rep2_CGGCTATGCTAATGCTTTGGAAGTCAGGACGT	IN2
rep2_TCCGCGAATCTATCCGAAGAGATGCAGGACGT	EX3
rep2_GAGATTCCATAAGTCGATAGCCTTCAGGACGT	EX2
rep2_TCCGCGAACTTCAATGTTCATCCAGGCTCTGA	EX2
rep2_CTGAAGCTGAATTACGAACGAACGCAGGACGT	EX2
rep2_TCCGCGAACGCTTGATTTCATCCAATAGAGGC	EX2
rep2_AGCGATAGGTCTACCATTCATCCACAGGACGT	MG
rep2_CTGAAGCTGCCTCAATAGGATAACCAGGACGT	IN1
rep2_AGCGATAGAACCAGGTGGATACTATATAGCCT	MG
rep2_ATTCAGAATCTATCCGTTCATCCACCTATCCT	EX3
rep2_CGCTCATTTATGCCATGAAGTATGTATAGCCT	OC
rep2_GAGATTCCGCAACCTATGCCTTACATAGAGGC	EX2
rep2_ATTCAGAAGCAACCTAATAGCCTTCCTATCCT	IN1
rep2_GAGATTCCGTCATGAAATTCGTTGCAGGACGT	EX2
rep2_CGCTCATTGCAACCTAATTCGTTGCCTATCCT	EX2
rep2_CGGCTATGGTCATGAAAGGATAACATAGAGGC	OC
rep2_GAGATTCCCGTATAGATTGGAAGTCCTATCCT	EX1
rep2_CTGAAGCTGTCTACCAATAGCCTTCAGGACGT	OC
rep2_CGCTCATTGAATTACGGGTTAGACCCTATCCT	EX3
rep2_ATTCAGAATATGGTCGGGATACTACAGGACGT	EX3
rep2_CGCTCATTAACCAGGTTAAGATCCCCTATCCT	EX2
rep2_GAGATTCCATAAGTCGTCCGGTAACAGGACGT	MG
rep2_CGCTCATTTATGCCATAATGACGTGGCTCTGA	EX3
rep2_TCCGCGAAGTCTACCAAATGACGTGGCTCTGA	EX3
rep2_TCCGGAGAGAATTACGTAAGATCCTATAGCCT	IN2
rep2_ATTACTCGTTAGCCTCTAAGATCCCAGGACGT	EX3
rep2_GAGATTCCACGAATCTGAAGTATGATAGAGGC	EX3
rep2_TCCGCGAATGCCAATTTTGGAAGTCAGGACGT	OC
rep2_TCCGGAGAGTCTACCAATTCGTTGCAGGACGT	IN2
rep2_GAGATTCCTATGCCATATAGCCTTCAGGACGT	IN2
rep2_GAGATTCCCAGAACTGTAAGATCCCAGGACGT	IN2
rep2_AGCGATAGCAAGTTCAGGATACTACCTATCCT	EX3
rep2_GAGATTCCTACTGCCTAATGACGTCAGGACGT	EX1
rep2_TCCGCGAATATGCCATTTACGACCATAGAGGC	EX3
rep2_CTGAAGCTTATGCCATGGTTAGACCAGGACGT	MG
rep2_CGCTCATTGAATTACGTCCGGTAACAGGACGT	EX3
rep2_CTGAAGCTGCAACCTAGAAGTATGCAGGACGT	OC
rep2_TCCGCGAAACGAATCTTTACGACCGGCTCTGA	EX3
rep2_TAATGCGCTATGCCATTGCCTTACTATAGCCT	OC
rep2_ATTCAGAATACTGCCTGGATACTAATAGAGGC	IN2
rep2_CGCTCATTATAAGTCGAGGATAACATAGAGGC	EX3
rep2_ATTACTCGGTCTACCATCCGGTAATATAGCCT	OC
rep2_AGCGATAGAAGCAACGGAAGTATGCAGGACGT	EX2
rep2_ATTACTCGCGTATAGATTACGACCATAGAGGC	EX2
rep2_CGGCTATGGCCTCAATAGGATAACATAGAGGC	EX3
rep2_GAGATTCCCGTATAGAAGGATAACCAGGACGT	IN1
rep2_GAGATTCCGCCTCAATAGGATAACTATAGCCT	MG
rep2_ATTCAGAACAAGTTCAATAGCCTTCCTATCCT	EX3
rep2_TCCGGAGAACGTTCGATCCGGTAATATAGCCT	EX2
rep2_CGCTCATTAAGCAACGCGAATTCCTATAGCCT	EX1
rep2_CGGCTATGTATGCCATTTGGAAGTTATAGCCT	EX1
rep2_TCCGGAGAGTCATGAAAACGAACGATAGAGGC	EX1
rep2_AGCGATAGGCAACCTAAGGATAACCAGGACGT	MG
rep2_GAGATTCCTTAGCCTCCGAATTCCGGCTCTGA	IN2
rep2_TCCGGAGATTAGCCTCGGATACTATATAGCCT	IN2
rep2_TCCGGAGAAACCAGGTAACGAACGCAGGACGT	OC
rep2_CGGCTATGGCCTCAATTGCCTTACCAGGACGT	EX3
rep2_AGCGATAGGTCATGAATGCCTTACCAGGACGT	IN2
rep2_TAATGCGCTATGCCATATAGCCTTTATAGCCT	IN2
rep2_ATTCAGAACTTCAATGAACGAACGGGCTCTGA	EX3
rep2_TCCGGAGACTAATGCTATTCGTTGCAGGACGT	EX1
rep2_TAATGCGCCGTATAGACGAATTCCCCTATCCT	IN2
rep2_CGCTCATTACGTTCGAAGGATAACCCTATCCT	EX1
rep2_TCCGGAGAAACCAGGTGAAGTATGATAGAGGC	EX3
rep2_CGGCTATGACGAATCTTTACGACCCAGGACGT	OC
rep2_ATTACTCGGAACGGTATTCATCCACAGGACGT	IN1
rep2_CGGCTATGTACTGCCTAGGATAACTATAGCCT	EX3
rep2_TCCGGAGAGTCATGAAAAGAGATGGGCTCTGA	EX2
rep2_TCCGGAGACGTATAGAAAGAGATGTATAGCCT	IN2
rep2_ATTACTCGCGCTTGATGAAGTATGATAGAGGC	EX3
rep2_ATTACTCGGCAACCTAGAAGTATGCCTATCCT	EX3
rep2_GAGATTCCGAATTACGTTGGAAGTTATAGCCT	EX2
rep2_ATTCAGAATATGGTCGAATGACGTCCTATCCT	EX3
rep2_AGCGATAGCGCTTGATTAAGATCCCAGGACGT	MG
rep2_GAGATTCCGCAACCTAATTCGTTGATAGAGGC	IN1
rep2_TCCGGAGACTTCAATGAAGAGATGCCTATCCT	EX3
rep2_CGGCTATGACGTTCGAGGTTAGACATAGAGGC	EX2
rep2_GAGATTCCTATGCCATTGCCTTACGGCTCTGA	EX3
rep2_ATTCAGAAGTCATGAAGGATACTACCTATCCT	EX3
rep2_TCCGGAGAGTCATGAAGGATACTAGGCTCTGA	IN1
rep2_TCCGCGAAGAATTACGGAAGTATGGGCTCTGA	IN1
rep2_CGGCTATGCTTCAATGTTCATCCATATAGCCT	EX1
rep2_ATTCAGAATATGCCATAATGACGTCCTATCCT	OC
rep2_TCCGGAGACGCTTGATGGATACTACCTATCCT	EX1
rep2_ATTCAGAAGCAACCTATGCCTTACATAGAGGC	EX3
rep2_CGGCTATGGAATTACGTTGGAAGTCAGGACGT	EX3
rep2_TCCGCGAAAACCAGGTGGATACTAATAGAGGC	EX2
rep2_TAATGCGCTATGGTCGAGGATAACTATAGCCT	EX2
rep2_TCCGCGAAACGAATCTTTGGAAGTATAGAGGC	OC
rep2_GAATTCGTGCAACCTAAGGATAACTATAGCCT	EX2
rep2_TCCGGAGAAAGCAACGTTACGACCCAGGACGT	EX2
rep2_AGCGATAGCTTCAATGAGGATAACTATAGCCT	MG
rep2_AGCGATAGACGAATCTGAAGTATGATAGAGGC	MG
rep2_CGCTCATTTATGGTCGTCCGGTAACCTATCCT	IN1
rep2_CTGAAGCTCGTATAGACGAATTCCGGCTCTGA	EX3
rep2_GAGATTCCTATGCCATAACGAACGCAGGACGT	EX2
rep2_CGCTCATTACGAATCTAATGACGTATAGAGGC	OC
rep2_GAGATTCCAAGCAACGGGATACTACAGGACGT	OC
rep2_TCCGGAGAGTCTACCATCCGGTAACAGGACGT	IN2
rep2_GAGATTCCCGCTTGATTTCATCCAGGCTCTGA	EX2
rep2_ATTCAGAAACGAATCTAAGAGATGCCTATCCT	EX3
rep2_AGCGATAGGAACGGTATTCATCCATATAGCCT	OC
rep2_GAGATTCCTACTGCCTATAGCCTTTATAGCCT	IN2
rep2_CGCTCATTCAGAACTGTGCCTTACATAGAGGC	AC
rep2_CGCTCATTACGAATCTAAGAGATGGGCTCTGA	IN1
rep2_GAGATTCCATAAGTCGAGGATAACCAGGACGT	IN2
rep2_TCTCGCGCGAATTACGTGCCTTACCAGGACGT	EX1
rep2_ATTCAGAAGCCTCAATTGCCTTACATAGAGGC	EX2
rep2_CGGCTATGACGTTCGAAACGAACGCAGGACGT	EX1
rep2_CGGCTATGTGCCAATTTTGGAAGTCAGGACGT	OC
rep2_CGCTCATTGTCATGAAAACGAACGATAGAGGC	EX2
rep2_CGGCTATGAAGCAACGTTACGACCGGCTCTGA	EX3
rep2_CGCTCATTGAACGGTATTACGACCCAGGACGT	OC
rep2_TCCGGAGAAAGCAACGAGGATAACCAGGACGT	OC
rep2_ATTCAGAATCTATCCGGGTTAGACGGCTCTGA	IN2
rep2_ATTACTCGCGCTTGATCGAATTCCCCTATCCT	EX3
rep2_GAGATTCCCGCTTGATAGGATAACGGCTCTGA	EX2
rep2_TCTCGCGCCTTCAATGTGCCTTACTATAGCCT	EX2
rep2_ATTCAGAAGCAACCTATCCGGTAACAGGACGT	IN1
rep2_ATTACTCGCTTCAATGTTCATCCACAGGACGT	IN1
rep2_ATTCAGAATACTGCCTAGGATAACCAGGACGT	EX2
rep2_GAGATTCCGAACGGTATCCGGTAAATAGAGGC	EX3
rep2_CTGAAGCTCTAATGCTAGGATAACATAGAGGC	MG
rep2_CGGCTATGGCAACCTAAATGACGTATAGAGGC	IN2
rep2_GAGATTCCGTCATGAAAACGAACGATAGAGGC	EX3
rep2_GAGATTCCGTCTACCAAACGAACGCAGGACGT	IN1
rep2_CGCTCATTTTAGCCTCTTACGACCCCTATCCT	EX3
rep2_TCCGCGAAGTCTACCAATAGCCTTCAGGACGT	MG
rep2_CTGAAGCTGTCATGAAGGTTAGACATAGAGGC	EX1
rep2_CGCTCATTTGCCAATTAAGAGATGCCTATCCT	EX1
rep2_CGGCTATGATAAGTCGTGCCTTACCAGGACGT	EX3
rep2_CTGAAGCTGAATTACGGAAGTATGCAGGACGT	AC
rep2_GAGATTCCAACCAGGTTCCGGTAACCTATCCT	EX2
rep2_GAGATTCCTATGCCATTTGGAAGTTATAGCCT	OC
rep2_TCCGCGAACAAGTTCATCCGGTAAGGCTCTGA	EX2
rep2_TCCGCGAAGCCTCAATAGGATAACCAGGACGT	EX2
rep2_TCCGCGAAAAGCAACGAAGAGATGTATAGCCT	EX1
rep2_ATTACTCGCTAATGCTTGCCTTACATAGAGGC	EX3
rep2_CTGAAGCTTATGGTCGTGCCTTACCCTATCCT	EX2
rep2_GAGATTCCGTCTACCAGAAGTATGCAGGACGT	IN2
rep2_TCCGCGAACAGAACTGGGTTAGACGGCTCTGA	EX3
rep2_AGCGATAGCTTCAATGAAGAGATGATAGAGGC	OC
rep2_ATTACTCGGTCTACCATTGGAAGTCCTATCCT	EX3
rep2_CGCTCATTTTCCATCCTAAGATCCGGCTCTGA	EX1
rep2_CGCTCATTGTCTACCAAAGAGATGATAGAGGC	EX3
rep2_CGCTCATTCTTCAATGTGCCTTACTATAGCCT	AC
rep2_ATTCAGAATACTGCCTTAAGATCCCCTATCCT	EX2
rep2_CTGAAGCTTACTGCCTTGCCTTACATAGAGGC	IN2
rep2_CGCTCATTCTTCAATGAGGATAACATAGAGGC	EX1
rep2_ATTCAGAATTAGCCTCTTCATCCATATAGCCT	EX3
rep2_AGCGATAGTATGGTCGAATGACGTTATAGCCT	EX2
rep2_CGCTCATTTCTATCCGTTACGACCGGCTCTGA	IN2
rep2_TAATGCGCACGAATCTAAGAGATGCAGGACGT	EX3
rep2_TCCGCGAACTTCAATGTGCCTTACCAGGACGT	IN2
rep2_CTGAAGCTGCAACCTAATAGCCTTCCTATCCT	IN1
rep2_ATTCAGAAGTCTACCATTGGAAGTCCTATCCT	EX3
rep2_TCCGGAGAGCCTCAATATAGCCTTCAGGACGT	OC
rep2_AGCGATAGCAAGTTCAAGGATAACTATAGCCT	IN2
rep2_CGGCTATGACGTTCGATTCATCCAATAGAGGC	EX1
rep2_CTGAAGCTGTCTACCAGGATACTATATAGCCT	AC
rep2_CGGCTATGCAAGTTCAATTCGTTGTATAGCCT	IN2
rep2_AGCGATAGGAACGGTACGAATTCCATAGAGGC	EX3
rep2_AGCGATAGGAACGGTAAATGACGTATAGAGGC	AC
rep2_CTGAAGCTCAAGTTCAAATGACGTCAGGACGT	IN1
rep2_AGCGATAGACGAATCTATTCGTTGCAGGACGT	OC
rep2_TAATGCGCTTAGCCTCCGAATTCCATAGAGGC	IN2
rep2_GAGATTCCTCTATCCGTGCCTTACATAGAGGC	OC
rep2_ATTACTCGTATGGTCGAAGAGATGATAGAGGC	IN2
rep2_TAATGCGCTATGGTCGGGATACTAGGCTCTGA	EX3
rep2_CTGAAGCTGCAACCTATTACGACCATAGAGGC	IN2
rep2_AGCGATAGAAGCAACGAACGAACGCAGGACGT	AC
rep2_CGGCTATGACGAATCTAGGATAACCAGGACGT	OC
rep2_TCCGGAGAAACCAGGTTTCATCCAATAGAGGC	MG
rep2_TCCGGAGATTAGCCTCTTGGAAGTGGCTCTGA	IN2
rep2_CGCTCATTACGAATCTAGGATAACCAGGACGT	IN1
rep2_CGGCTATGGAATTACGGGTTAGACCAGGACGT	IN2
rep2_GAGATTCCCTAATGCTGAAGTATGATAGAGGC	AC
rep2_TAATGCGCTATGGTCGCGAATTCCATAGAGGC	EX2
rep2_AGCGATAGTCTATCCGTTGGAAGTCCTATCCT	EX1
rep2_GAGATTCCCTTCAATGGGATACTAATAGAGGC	OC
rep2_CGCTCATTGCAACCTAGGTTAGACTATAGCCT	MG
rep2_TCCGCGAAAAGCAACGTTACGACCCAGGACGT	OC
rep2_TCCGCGAAGAATTACGGGTTAGACATAGAGGC	IN2
rep2_TCCGGAGAGCCTCAATTCCGGTAAGGCTCTGA	EX2
rep2_ATTACTCGCTAATGCTGGATACTACCTATCCT	EX2
rep2_AGCGATAGGTCATGAAATAGCCTTATAGAGGC	OC
rep2_TAATGCGCTATGCCATTGCCTTACATAGAGGC	IN1
rep2_TAATGCGCTTAGCCTCTAAGATCCTATAGCCT	EX3
rep2_CGGCTATGCAAGTTCACGAATTCCATAGAGGC	OC
rep2_TCCGCGAACAAGTTCATCCGGTAACAGGACGT	EX3
rep2_ATTCAGAACAGAACTGAATGACGTCAGGACGT	IN1
rep2_AGCGATAGTATGCCATGAAGTATGATAGAGGC	OC
rep2_GAGATTCCAACCAGGTTGCCTTACATAGAGGC	MG
rep2_ATTCAGAAACGAATCTTAAGATCCCCTATCCT	EX2
rep2_TCCGCGAAGCAACCTACGAATTCCTATAGCCT	OC
rep2_ATTACTCGAAGCAACGAGGATAACGGCTCTGA	EX2
rep2_ATTCAGAACTTCAATGGGATACTACCTATCCT	EX3
rep2_TCCGGAGACGTATAGATTACGACCCAGGACGT	IN2
rep2_TCCGGAGATATGCCATGAAGTATGGGCTCTGA	IN2
rep2_ATTACTCGAAGCAACGTTGGAAGTTATAGCCT	OC
rep2_CGGCTATGAAGCAACGCGAATTCCTATAGCCT	OC
rep2_CTGAAGCTTTCCATCCTTGGAAGTCAGGACGT	EX3
rep2_GAGATTCCACGTTCGAGGATACTACCTATCCT	MG
rep2_GAGATTCCAACCAGGTAGGATAACGGCTCTGA	EX2
rep2_ATTCAGAACTAATGCTTGCCTTACTATAGCCT	IN2
rep2_ATTCAGAAACGTTCGAGGTTAGACCAGGACGT	IN2
rep2_CGGCTATGACGAATCTTTCATCCACAGGACGT	OC
rep2_GAGATTCCTATGGTCGATAGCCTTCCTATCCT	EX2
rep2_GAGATTCCTTAGCCTCGGTTAGACCAGGACGT	IN2
rep2_TCCGCGAAGCCTCAATTGCCTTACCAGGACGT	OC
rep2_TCCGGAGACGTATAGAAAGAGATGGGCTCTGA	EX1
rep2_TCCGCGAACTAATGCTAGGATAACCAGGACGT	EX1
rep2_AGCGATAGTATGCCATTTACGACCATAGAGGC	AC
rep2_CGCTCATTTGCCAATTTTACGACCATAGAGGC	IN1
rep2_CGCTCATTAACCAGGTAACGAACGCCTATCCT	EX2
rep2_ATTCAGAATTCCATCCTGCCTTACCCTATCCT	EX2
rep2_CTGAAGCTTATGCCATGAAGTATGTATAGCCT	OC
rep2_TCCGCGAAGCAACCTAATAGCCTTGGCTCTGA	EX3
rep2_ATTACTCGGCAACCTATTACGACCCAGGACGT	EX2
rep2_CTGAAGCTAAGCAACGATTCGTTGCCTATCCT	IN1
rep2_GAGATTCCACGAATCTGGATACTAATAGAGGC	EX3
rep2_TCCGGAGATCTATCCGCGAATTCCATAGAGGC	IN2
rep2_TCCGGAGATGCCAATTAACGAACGTATAGCCT	EX1
rep2_CTGAAGCTATAAGTCGTTGGAAGTCCTATCCT	EX2
rep2_TCCGGAGACAGAACTGTTGGAAGTTATAGCCT	EX3
rep2_GAGATTCCCTAATGCTGGTTAGACATAGAGGC	IN1
rep2_CTGAAGCTAAGCAACGAACGAACGTATAGCCT	EX3
rep2_CTGAAGCTTCTATCCGATAGCCTTTATAGCCT	EX2
rep2_CGGCTATGCTTCAATGTTGGAAGTTATAGCCT	OC
rep2_GAGATTCCTCTATCCGAATGACGTCAGGACGT	OC
rep2_AGCGATAGACGTTCGAATTCGTTGATAGAGGC	OC
rep2_ATTCAGAATATGGTCGTCCGGTAACCTATCCT	EX3
rep2_ATTACTCGTTAGCCTCTGCCTTACTATAGCCT	OC
rep2_AGCGATAGCAGAACTGTAAGATCCTATAGCCT	IN1
rep2_CGCTCATTCTAATGCTAACGAACGCAGGACGT	EX3
rep2_GAGATTCCAAGCAACGAGGATAACTATAGCCT	EX3
rep2_TCCGGAGATATGGTCGCGAATTCCATAGAGGC	OC
rep2_TCCGCGAAGCAACCTAAAGAGATGATAGAGGC	IN1
rep2_CTGAAGCTGTCATGAAATTCGTTGGGCTCTGA	IN2
rep2_TCCGGAGAGAATTACGAAGAGATGGGCTCTGA	EX1
rep2_GAGATTCCTCTATCCGGAAGTATGTATAGCCT	OC
rep2_TCCGGAGAGCCTCAATTTGGAAGTCAGGACGT	MG
rep2_CTGAAGCTGTCTACCACGAATTCCCAGGACGT	EX2
rep2_CGGCTATGTTCCATCCTGCCTTACATAGAGGC	MG
rep2_TCCGCGAAGTCATGAATTCATCCATATAGCCT	EX3
rep2_TAATGCGCAAGCAACGCGAATTCCTATAGCCT	EX3
rep2_ATTCAGAATATGCCATATTCGTTGCAGGACGT	EX2
rep2_TCCGGAGAATAAGTCGAGGATAACCCTATCCT	OC
rep2_CTGAAGCTCGTATAGAAAGAGATGCAGGACGT	EX3
rep2_GAGATTCCCGCTTGATAGGATAACCAGGACGT	EX1
rep2_GAGATTCCAACCAGGTAGGATAACCAGGACGT	OC
rep2_CGGCTATGCGCTTGATAAGAGATGCAGGACGT	IN2
rep2_CGGCTATGATAAGTCGTAAGATCCCAGGACGT	MG
rep2_CGGCTATGTATGGTCGAATGACGTTATAGCCT	IN2
rep2_AGCGATAGGAACGGTAAAGAGATGGGCTCTGA	EX3
rep2_GAGATTCCCAAGTTCAGAAGTATGCAGGACGT	MG
rep2_ATTACTCGATAAGTCGAACGAACGTATAGCCT	IN1
rep2_ATTCAGAAGAATTACGTGCCTTACCCTATCCT	EX3
rep2_CGCTCATTGCCTCAATTCCGGTAATATAGCCT	IN2
rep2_ATTCAGAATTCCATCCTAAGATCCCAGGACGT	OC
rep2_ATTACTCGAAGCAACGTTGGAAGTATAGAGGC	EX1
rep2_CTGAAGCTGTCTACCAAAGAGATGTATAGCCT	AC
rep2_CTGAAGCTCAGAACTGTTCATCCAATAGAGGC	EX3
rep2_TCCGCGAAGAACGGTATTACGACCCAGGACGT	AC
rep2_CGGCTATGCGTATAGATTACGACCCCTATCCT	EX2
rep2_CTGAAGCTTACTGCCTTTGGAAGTCAGGACGT	AC
rep2_CGCTCATTTGCCAATTTCCGGTAATATAGCCT	EX1
rep2_TCCGCGAAACGTTCGAGAAGTATGCAGGACGT	EX2
rep2_GAGATTCCCGCTTGATGAAGTATGCAGGACGT	MG
rep2_TCCGGAGACAGAACTGAGGATAACCCTATCCT	OC
rep2_GAGATTCCCAAGTTCATGCCTTACATAGAGGC	EX2
rep2_TCCGCGAAGCCTCAATAAGAGATGATAGAGGC	IN2
rep2_CGCTCATTTTCCATCCTAAGATCCCCTATCCT	OC
rep2_TCCGGAGATATGCCATTAAGATCCATAGAGGC	EX3
rep2_CGCTCATTCGTATAGATAAGATCCCCTATCCT	EX1
rep2_GAGATTCCCGTATAGAGGATACTAGGCTCTGA	EX3
rep2_TCCGGAGAGTCATGAAGGTTAGACATAGAGGC	OC
rep2_GAGATTCCTCTATCCGGAAGTATGCCTATCCT	OC
rep2_ATTCAGAAGAATTACGAATGACGTTATAGCCT	EX2
rep2_ATTACTCGGTCTACCAGGTTAGACATAGAGGC	EX3
rep2_GAGATTCCGAACGGTAAAGAGATGCAGGACGT	IN2
rep2_GAGATTCCCTTCAATGAACGAACGTATAGCCT	IN2
rep2_GAGATTCCGCCTCAATAGGATAACATAGAGGC	MG
rep2_TCCGGAGAGTCTACCATTGGAAGTCCTATCCT	EX3
rep2_GAGATTCCAACCAGGTAAGAGATGCAGGACGT	EX2
rep2_TCCGCGAACTTCAATGAAGAGATGCAGGACGT	IN2
rep2_GAGATTCCTATGGTCGAGGATAACTATAGCCT	EX2
rep2_TCCGCGAATCTATCCGCGAATTCCATAGAGGC	EX3
rep2_CGCTCATTGCAACCTATTGGAAGTTATAGCCT	EX2
rep2_CGGCTATGAACCAGGTAATGACGTTATAGCCT	OC
rep2_GAGATTCCTTCCATCCCGAATTCCCCTATCCT	IN2
rep2_GAGATTCCCGTATAGAATAGCCTTATAGAGGC	OC
rep2_TCCGCGAACTTCAATGGGTTAGACCAGGACGT	IN2
rep2_CTGAAGCTAACCAGGTAGGATAACATAGAGGC	IN1
rep2_CGCTCATTCAAGTTCACGAATTCCTATAGCCT	OC
rep2_CGCTCATTGAACGGTATTGGAAGTATAGAGGC	EX2
rep2_GAGATTCCGTCATGAATTCATCCATATAGCCT	IN2
rep2_AGCGATAGTGCCAATTTTACGACCCAGGACGT	IN1
rep2_TCCGGAGAGCCTCAATATTCGTTGCAGGACGT	IN1
rep2_ATTCAGAATGCCAATTATTCGTTGATAGAGGC	EX3
rep2_TCCGGAGAGCAACCTAAGGATAACCAGGACGT	MG
rep2_ATTACTCGTTAGCCTCTCCGGTAAGGCTCTGA	EX3
rep2_CGCTCATTTATGGTCGTGCCTTACCCTATCCT	EX3
rep2_ATTCAGAAGCAACCTAAACGAACGCAGGACGT	IN2
rep2_CTGAAGCTACGAATCTTTACGACCCAGGACGT	OC
rep2_CGCTCATTCTTCAATGTCCGGTAAATAGAGGC	EX3
rep2_CGCTCATTTACTGCCTAATGACGTCAGGACGT	OC
rep2_CTGAAGCTAAGCAACGTAAGATCCATAGAGGC	IN2
rep2_CGGCTATGTACTGCCTATAGCCTTTATAGCCT	EX2
rep2_CGCTCATTATAAGTCGATTCGTTGTATAGCCT	IN2
rep2_TCCGGAGAGTCATGAAATAGCCTTATAGAGGC	OC
rep2_ATTCAGAAGTCATGAAGGATACTAATAGAGGC	IN1
rep2_TCCGGAGAGCAACCTAGGTTAGACATAGAGGC	EX2
rep2_AGCGATAGAACCAGGTGAAGTATGTATAGCCT	OC
rep2_TCCGGAGATTAGCCTCTTGGAAGTCCTATCCT	EX1
rep2_TAATGCGCATAAGTCGATAGCCTTGGCTCTGA	EX3
rep2_TCTCGCGCCGCTTGATTAAGATCCTATAGCCT	EX2
rep2_AGCGATAGTATGGTCGTAAGATCCTATAGCCT	MG
rep2_TCCGCGAACTAATGCTTCCGGTAACAGGACGT	IN1
rep2_TCCGGAGAGCCTCAATAATGACGTGGCTCTGA	EX2
rep2_TCCGGAGACAGAACTGATAGCCTTGGCTCTGA	MG
rep2_TCCGCGAAAAGCAACGATTCGTTGTATAGCCT	EX3
rep2_ATTCAGAAGCAACCTAGGATACTACAGGACGT	IN1
rep2_CTGAAGCTACGTTCGAATTCGTTGATAGAGGC	IN2
rep2_TCCGGAGATTCCATCCCGAATTCCATAGAGGC	IN1
rep2_CTGAAGCTTGCCAATTAACGAACGCAGGACGT	OC
rep2_CTGAAGCTCAGAACTGAGGATAACCAGGACGT	EX3
rep2_GAGATTCCGTCTACCAATTCGTTGCCTATCCT	EX2
rep2_ATTCAGAATTAGCCTCAGGATAACCAGGACGT	EX2
rep2_CGGCTATGACGAATCTTTGGAAGTTATAGCCT	IN2
rep2_TCCGCGAAGAACGGTAATAGCCTTGGCTCTGA	EX3
rep2_GAGATTCCGAATTACGTTACGACCGGCTCTGA	EX2
rep2_GAGATTCCGAACGGTATAAGATCCCCTATCCT	MG
rep2_TAATGCGCCAGAACTGCGAATTCCTATAGCCT	EX2
rep2_TCCGGAGATTAGCCTCTAAGATCCTATAGCCT	IN2
rep2_ATTCAGAAATAAGTCGTAAGATCCCCTATCCT	EX1
rep2_TCCGGAGATATGGTCGATAGCCTTGGCTCTGA	OC
rep2_CTGAAGCTAACCAGGTGAAGTATGCAGGACGT	EX2
rep2_GAGATTCCAACCAGGTAACGAACGCCTATCCT	EX2
rep2_CTGAAGCTTGCCAATTGAAGTATGCAGGACGT	OC
rep2_AGCGATAGTTAGCCTCCGAATTCCTATAGCCT	MG
rep2_TAATGCGCCAAGTTCATTGGAAGTCAGGACGT	EX3
rep2_AGCGATAGATAAGTCGTTCATCCAATAGAGGC	MG
rep2_CGCTCATTCAGAACTGTAAGATCCCCTATCCT	EX3
rep2_ATTACTCGCTTCAATGGGTTAGACGGCTCTGA	EX2
rep2_TCCGGAGATGCCAATTTTCATCCACCTATCCT	EX3
rep2_TCCGCGAACTAATGCTGGTTAGACCAGGACGT	MG
rep2_GAGATTCCCTTCAATGGGTTAGACCCTATCCT	MG
rep2_CGGCTATGCAGAACTGTGCCTTACCAGGACGT	AC
rep2_AGCGATAGTTAGCCTCAAGAGATGATAGAGGC	EX2
rep2_TCCGCGAAATAAGTCGGGATACTACAGGACGT	OC
rep2_GAGATTCCGAATTACGTTACGACCATAGAGGC	OC
rep2_TCCGGAGACGCTTGATTCCGGTAACAGGACGT	IN2
rep2_TCCGGAGAGAACGGTAATAGCCTTCAGGACGT	OC
rep2_CGGCTATGGCAACCTAGGATACTACAGGACGT	OC
rep2_TCCGGAGAGAATTACGTAAGATCCCCTATCCT	EX3
rep2_AGCGATAGCGTATAGATTCATCCACCTATCCT	EX3
rep2_TCCGGAGATATGGTCGGGTTAGACATAGAGGC	OC
rep2_TCCGCGAAATAAGTCGATTCGTTGGGCTCTGA	AC
rep2_TCCGGAGAGCAACCTAATAGCCTTATAGAGGC	EX2
rep2_TCCGCGAATTCCATCCCGAATTCCTATAGCCT	EX3
rep2_TCCGCGAACGCTTGATAACGAACGTATAGCCT	EX2
rep2_TCCGCGAATTAGCCTCATTCGTTGGGCTCTGA	EX1
rep2_TCCGGAGAAACCAGGTTAAGATCCCAGGACGT	OC
rep2_CTGAAGCTCAAGTTCAAATGACGTATAGAGGC	IN2
rep2_GAGATTCCGAATTACGAACGAACGTATAGCCT	IN2
rep2_ATTCAGAAATAAGTCGTTACGACCTATAGCCT	EX2
rep2_CGGCTATGTTAGCCTCGGATACTAATAGAGGC	IN1
rep2_AGCGATAGGTCTACCAGGTTAGACCCTATCCT	IN2
rep2_TCCGCGAACAGAACTGAAGAGATGCAGGACGT	AC
rep2_ATTACTCGTTCCATCCAAGAGATGTATAGCCT	EX3
rep2_GAGATTCCTACTGCCTATTCGTTGATAGAGGC	EX3
rep2_CGCTCATTTATGCCATAGGATAACCAGGACGT	AC
rep2_GAGATTCCTTAGCCTCGAAGTATGATAGAGGC	OC
rep2_GAGATTCCCAAGTTCAAACGAACGCCTATCCT	EX2
rep2_CGCTCATTCGCTTGATAAGAGATGCAGGACGT	IN2
rep2_GAGATTCCCGCTTGATCGAATTCCTATAGCCT	EX3
rep2_TCCGGAGAGAACGGTACGAATTCCCAGGACGT	AC
rep2_TCCGGAGACGTATAGAGAAGTATGCAGGACGT	EX3
rep2_TCCGCGAACAAGTTCAGGTTAGACCCTATCCT	EX2
rep2_CTGAAGCTGAATTACGATTCGTTGCAGGACGT	EX2
rep2_TCCGGAGAGCCTCAATATTCGTTGGGCTCTGA	IN1
rep2_GAGATTCCGAACGGTACGAATTCCATAGAGGC	AC
rep2_CGCTCATTCAAGTTCATTACGACCTATAGCCT	EX2
rep2_TAATGCGCGTCTACCAATTCGTTGTATAGCCT	EX1
rep2_CTGAAGCTTCTATCCGGGTTAGACGGCTCTGA	OC
rep2_CGGCTATGTGCCAATTATTCGTTGCAGGACGT	IN2
rep2_GAGATTCCGTCATGAATTGGAAGTTATAGCCT	IN2
rep2_TAATGCGCAAGCAACGATTCGTTGTATAGCCT	IN2
rep2_ATTCAGAACAGAACTGTAAGATCCCCTATCCT	EX3
rep2_GAGATTCCAAGCAACGTGCCTTACCCTATCCT	OC
rep2_AGCGATAGCAGAACTGAAGAGATGCCTATCCT	IN2
rep2_TCCGCGAATATGCCATGGTTAGACATAGAGGC	EX3
rep2_GAGATTCCTATGCCATGAAGTATGCAGGACGT	IN2
rep2_ATTCAGAACTAATGCTTAAGATCCCCTATCCT	MG
rep2_ATTACTCGAACCAGGTTGCCTTACTATAGCCT	EX3
rep2_TCCGGAGAATAAGTCGCGAATTCCTATAGCCT	AC
rep2_ATTACTCGCAGAACTGTTGGAAGTATAGAGGC	OC
rep2_TCCGGAGAACGAATCTGGTTAGACCAGGACGT	OC
rep2_GAGATTCCTATGCCATATTCGTTGATAGAGGC	MG
rep2_CGGCTATGCGTATAGAAATGACGTTATAGCCT	OC
rep2_TCCGGAGAGAATTACGTGCCTTACCCTATCCT	EX3
rep2_CGGCTATGCGCTTGATTCCGGTAATATAGCCT	EX3
rep2_GAGATTCCGAACGGTAAATGACGTTATAGCCT	AC
rep2_AGCGATAGCGTATAGAATAGCCTTTATAGCCT	IN2
rep2_TAATGCGCCGTATAGAATTCGTTGCCTATCCT	EX3
rep2_TCCGGAGAGCCTCAATTAAGATCCTATAGCCT	EX3
rep2_TCCGCGAAATAAGTCGAAGAGATGTATAGCCT	OC
rep2_CGCTCATTGAACGGTAAATGACGTATAGAGGC	MG
rep2_TCCGGAGAGAATTACGAATGACGTGGCTCTGA	EX1
rep2_TCCGGAGACTTCAATGAACGAACGCCTATCCT	EX3
rep2_CGGCTATGACGTTCGAGAAGTATGTATAGCCT	IN2
rep2_CTGAAGCTGAATTACGGAAGTATGTATAGCCT	EX1
rep2_CGCTCATTACGTTCGACGAATTCCATAGAGGC	EX2
rep2_TCCGGAGATTCCATCCAACGAACGGGCTCTGA	AC
rep2_GAGATTCCGCCTCAATAAGAGATGCAGGACGT	EX3
rep2_ATTCAGAATACTGCCTTAAGATCCCAGGACGT	OC
rep2_TCCGGAGACGCTTGATAATGACGTGGCTCTGA	EX2
rep2_TCCGGAGAACGAATCTTAAGATCCATAGAGGC	EX3
rep2_TCCGCGAAAACCAGGTAACGAACGCAGGACGT	OC
rep2_CGCTCATTCGTATAGAAACGAACGGGCTCTGA	IN1
rep2_GAGATTCCTACTGCCTTAAGATCCCAGGACGT	OC
rep2_GAGATTCCTTCCATCCTGCCTTACATAGAGGC	OC
rep2_TCCGGAGATTAGCCTCATAGCCTTGGCTCTGA	EX2
rep2_CGGCTATGACGAATCTATTCGTTGCAGGACGT	MG
rep2_AGCGATAGGTCATGAATTCATCCATATAGCCT	OC
rep2_TCCGCGAAGAACGGTAGGTTAGACCAGGACGT	OC
rep2_ATTCAGAACGTATAGATCCGGTAAATAGAGGC	EX2
rep2_CTGAAGCTCGTATAGATTACGACCTATAGCCT	IN2
rep2_TAATGCGCCAGAACTGCGAATTCCGGCTCTGA	EX1
rep2_TCCGGAGAGCAACCTATCCGGTAACAGGACGT	IN2
rep2_ATTACTCGGCAACCTATTGGAAGTTATAGCCT	MG
rep2_GAGATTCCGAACGGTATTCATCCACAGGACGT	EX3
rep2_TCCGGAGAAAGCAACGTCCGGTAACCTATCCT	EX3
rep2_AGCGATAGAAGCAACGGGATACTACCTATCCT	IN2
rep2_CGCTCATTTTCCATCCGGATACTAGGCTCTGA	EX3
rep2_CGGCTATGCTTCAATGTCCGGTAAATAGAGGC	AC
rep2_TCCGGAGAATAAGTCGGGATACTATATAGCCT	MG
rep2_CTGAAGCTTTCCATCCTGCCTTACCCTATCCT	EX3
rep2_CGGCTATGCTAATGCTATTCGTTGTATAGCCT	OC
rep2_TCCGGAGAAAGCAACGATAGCCTTGGCTCTGA	OC
rep2_TCCGGAGAACGAATCTTGCCTTACGGCTCTGA	IN2
rep2_TCCGGAGACTTCAATGTTGGAAGTCCTATCCT	IN2
rep2_CGCTCATTGCAACCTATGCCTTACATAGAGGC	IN2
rep2_AGCGATAGCTTCAATGGGATACTAATAGAGGC	EX3
rep2_ATTCAGAAGCCTCAATTCCGGTAACCTATCCT	EX3
rep2_CTGAAGCTGTCTACCAATTCGTTGTATAGCCT	OC
rep2_AGCGATAGGTCTACCAATTCGTTGATAGAGGC	IN2
rep2_ATTCAGAAATAAGTCGTTGGAAGTCCTATCCT	EX3
rep2_CGGCTATGTATGCCATAATGACGTTATAGCCT	OC
rep2_CGCTCATTACGTTCGAGGATACTATATAGCCT	OC
